XXXXXXXX
X-X@-X-X
XX--#--X
X--#---X
X----oXX
XXo---XX
X--X--XX
XXXXXXXo
