XXXXXXXX
X--@---X
X-##--XX
X----oXX
XoX--XXX
XX-X-X-X
X--XXo-X
XXXXXXXX
