XXXXXXXX
X--X-XXX
oX-XX-XX
XoXX-XXX
X--#---X
X---#--X
XXoXX@XX
XXXXXXXX
