XXXXXXXX
Xo-----X
XX--X#-X
XXX-#--X
XXX@X-oX
XX-XXX#X
XX-X--XX
XXXXXXXX
