XXXXXXXX
XX-XXX-X
XXo-XX-X
X-o-X@XX
X---##-X
XX-----X
X--o---X
XXXXXXXX
