XXXXXXXX
XXo---oX
XX--#--X
XX-#-#XX
X-X--XXX
X--@X-XX
X--X--XX
XXXXXXXX
