XXXXXXXX
XXXX---X
XX-XX--X
X-o----X
XX-@-X-X
XX-##-XX
Xo---X-X
XXXXXXXX
