XXXXXXXX
XX-X@-XX
XX-X---X
XXXX##-X
X-o----X
XX-X--oX
XXXX-XXX
oXXXXXXX
