XXXXXXXX
XX---X-X
XXX--X-X
XoX-X-XX
X---@XXX
X-##XXXX
X----o@X
XXXXXXXX
