XXXXXXXX
XX--X-XX
XXX-@--X
XX-#-#-X
Xo-----X
XXXX--oX
X--X--XX
XX#XXXXX
