XXXXXXXX
XXo----X
XX-X##-X
XXXX@--X
XXXX-XoX
X----XXX
X-----XX
XXXXXXoX
