XXXXXXXX
X-@--@-X
XXX-#-XX
XXXX-#-X
X-Xo---X
X-----oX
X-XX-XXX
XXXXXXXX
