XXXXXXXX
Xo---X-X
XX-#--@X
XXo#---X
XX---X-X
XXo-X-XX
XX--XXXX
XXXXXXXX
