XX@XXXXX
Xo--oX-X
X---XXXX
X-##XX-X
X--@XXXX
XXX---XX
XX--XXXX
XXXXXXXX
