XXXXXXXX
XX-@XX-X
X-X--XXX
X----XXX
X--##X-X
Xo-o-XXX
XXX--oXX
XXXXXXXX
