XXXXXXXX
XX-XX-oX
X-XX#X-X
XX-X-#-X
X---X#-X
XX-o---X
X--X-XXX
XXXXXXXX
