XXXXXXXX
X---oXXX
X-#--XXX
X@-#-XXX
X----XXX
X-X-oXXX
XX--X-XX
XX#XXXXX
