XXX#XXXX
XX-XX-XX
XX-XX--X
X--o--@X
XXX--#XX
X-X-#-XX
XXX---oX
XXXXXXXX
