XXXXXXXX
X--XXXXX
XXXo---X
XX---#-X
XXX--#@o
X-o----X
X---XX-X
XXXXXXXX
