XXXXXXXX
X-XXXXXX
XXX#X--X
X@-XoX-X
X------X
X-##-XXX
X----oXX
XXXXXXXX
