XXXXXXXX
X-X----X
X-X#--@X
X---#XXX
XXo----X
XXX---oX
XXXXX-Xo
XXXXXXXX
