XXXXXXXX
X-oX@-XX
XX-----X
X--#---X
XX-#--XX
Xo----XX
X--X-XXX
XXXXXoXX
