XXXXXXXX
X--XX-XX
XXXX-XXX
XXX--@oX
XX--#--X
X----X-X
X-Xo---X
XXXXXXXX
