XXXXXXXX
XX@--X-#
X---X-XX
X-##-XXX
X-----oX
XoX-XXXX
XX--XX-X
XXXXXXXX
