XXXXXXXX
XX-XXXXX
XXX--oXX
X-X-X-XX
X@X-#--X
XX-@#--X
X--XX-oX
XXXXXXXX
