XXXXXXXX
XX-----X
X-Xo---X
X---X#-X
Xo--#--X
X--@XXoX
XX-XXXXX
XXXXXXXX
