XXXXXXXX
XXX-X-Xo
X-o----X
XXX--o-X
XXX#X-XX
XX@-#-XX
XXX----X
XXXXXXXX
