XXXXXXXX
XXX---XX
o-XX-oXX
X--#---X
X---#--X
X@-XXXoX
X--XX-XX
XXXXXXXX
