@XXXXXXX
X-Xo---X
X-X--@-X
X----#-X
XXX-#-XX
X-X---oX
X--XXX-X
XXXXXXXX
