XXXXXXXX
XX---XXX
XXX-XXXX
XXXX-XoX
X--o---X
X-@X#--X
XXo----X
XXXXXXXX
