XXXXXXXX
XX-X-XXX
XX-X@XoX
X-XX#--X
XXXX-X-X
X-X--#-X
XXXo---X
#XXXXXXX
