XXXXXXXX
X-XXoX-@
XXX--XXX
X--#@X-X
X--#---X
XoXX---X
XXXX--XX
XXXXXXXX
