XXXXXXXX
XX-X-XXX
XX--#@XX
XoX----X
X----XXX
X-##X--X
X----oXX
XXXXXXXX
