XXXXXXXX
XX---o-X
XX-#--@X
XX@#-XXX
XX---oXX
X--XXX-X
X---XXXX
XXXXXXXX
