XXXXXXXX
X---oXXX
X-#-XX@X
X--#---X
XoX@---X
XXXXXXXX
X--XXXXX
XXXXXXXX
