XXXXXXXX
X--X#XXX
X-X---@X
X-XX-#-X
XXX--#XX
X-Xo--XX
XX----oX
XXXXXXXX
