XXXXXXXX
X--@--XX
X@#-XXXX
X--#---X
Xo----oX
XXX-X--X
XX--X--X
XXXXXXXX
