XXXXXXXX
XXX-@X-X
X--#XX-X
X-#----X
X---oXXX
XoX-X-@X
XXXXXXXX
XXXXXXXX
