XXXXXXXX
X---o-XX
X-#-XXXX
X--#X--X
Xo--@X#X
XX-XXXXX
X-XX--XX
XXXXXXXX
