XXXXXXXX
Xo----oX
XXX##-XX
XX@---@X
XXX--X-X
X--X-XXX
X---XXXX
XXXXXXXX
