XXXXXXXX
X-o---oX
XX@-#--X
XX---#-X
#------X
XXX-XX-X
X----XXX
XXXXXXXX
