XXXXXXXX
XXo--XXX
X------X
X--#-@XX
X--#-XXX
X-XXX--X
Xo--XX-X
XXXXX#XX
