XXXXXXXX
XX--XXXX
XX--XX-X
XX-#@--X
XX-#X@-X
Xo-----X
XX--o--X
XXXXXXXX
