XXXXXXXX
XXX--oXX
X----XXX
X-#-#XXX
X-X--@XX
Xo#-XXXX
XXX--XXX
XXXXXXXX
