XXXXXXXX
XX-@-X-X
XX--#X-X
X--#--XX
XXX--oXX
X@o--X-X
XX--X--X
XXXXXXXX
