XXXXXXXX
XXX--XXX
X-XXX-oX
X--@#--X
X-XX#--X
X-o----X
XXXXX-XX
#XXXXXXX
