XXXXXXXX
XoX----X
X--#@--X
X-X#-XXX
X---X-X#
X---oXXX
X--X--XX
XXXXXXXX
