XXXXXXXX
XXXXXXXX
X-X-XXXX
XXX--oXX
XX-#---X
XX@-#-XX
X-----oo
XXXXXXXX
