XXXXXXXX
X-X-XXXX
X-X-X--X
X-XX-XoX
XX-#---X
X@-#---X
XX--#oXX
XXXXXXXX
