XXXXXXXX
XXXXX-XX
XXXXX--X
XXXo@-XX
XXX--#-X
X---#--X
XX----oX
XXXXX@XX
