XXXXXXXX
Xo--oXXX
Xo--XX-X
XX---XXX
XX##---X
X@----XX
X--X--XX
XXXXXXXX
