XXXXXXXX
XXX-XXXX
XX--o--X
XXX--X@X
X--#-#-X
Xo--X-XX
X-----XX
XXXXXXXX
