XXXXXXXX
X-----XX
XoX-XX#X
X---oX-X
X-#----X
X--#-@-X
XXX--XXX
XXXXXXXX
