XXXXXXXX
Xo---XXX
XX-#-X-X
XX--#-@X
XXo--X-X
X------X
XXX-X-XX
XXoXXXXX
