XXXXXXXX
XX----oX
X--#---X
X-X-#-XX
X--@X-XX
XX@XXoXX
XX--XXXX
XXXXXXXX
