XXXXXXXX
XXXXXXXX
X-XXXXXX
X-XX--XX
X-#-X--X
X-#---@X
X---oXXX
XXXXXXXX
