XXXXXXXX
X--XXXXX
X-#@---X
X---#XXX
XoX---oX
XXX-XX-X
X-XX-XX#
XXXXXXXX
