XXXXXXXX
XX@----X
X-X-#-XX
X-X@--oX
X---#-XX
X-o----X
X-XXX--X
XXXXXXXX
