XXXXXXXX
XoX-XXXX
XXXXoXXX
Xo@--XXX
XX-#--XX
X--#--XX
X-X---XX
XXXXXXXX
