XXXXXXXX
Xo---Xo#
X--##--X
X-@-X--X
X-----XX
XXX-XXXX
XXX---XX
XXXXXXXX
