XXXXXXXX
XX@#XX-X
XX--XXXX
X--#-X-X
X-#-XXXX
XX--oX-X
Xo--X-XX
XXXXXXXX
