XXXXXXXX
XX-X-XXX
X-----oX
X-@-#-#X
X--#---X
XX-XXo-X
XXXX-XXX
XXXXXXXX
