XXXXXXXX
XX-X@--X
XX--#--X
XXXX-#-X
X--o---X
X-X-XXoo
X------X
XXXXXXXX
