XXXXXXXX
Xo---XXX
X-X#---X
XX@#--XX
X--X-oXX
XXX-XXXX
X@---XXX
XXXXXXXX
