XXXXXXXX
XXX--oXX
XX-#-XoX
X-@#--XX
Xo-----X
XX-XXXXX
XXXXX--X
XXXXXXXX
