XXXXXXXX
XXX@--XX
X-X-#-XX
XX---#-X
X-Xo--XX
XXXX--oX
X-XXXXXX
XXX@XXXX
