XXXXXXXX
X-XXXX-X
XX-XXX-X
#-o---XX
XX--#-@X
XXX--#-X
XX-o---X
XXXXXXXX
