XXXXXXXX
X-Xo---X
XXXX---X
X-XX-#@X
X-X--#-X
XX-X-XXX
Xo-XoX-X
XXXXXXXX
