XXXXXXXX
XXXXXXXX
XXXoX-XX
XX-@---X
XX--##XX
XXo----X
XX-----X
XXXXXoXX
