XXXXXoXX
XX--X-XX
X-----oX
XX-#---X
X----#-X
XXoXXX@X
XX-X---X
XXXXXXXX
