XXXXXXXX
XXXX--XX
XXXoX--X
XXX--@XX
XX#-##-X
XXo----X
XX-----X
XXXXXXXX
