XXXXXXXX
XXX-XoXX
XX-X-o-X
X------X
X--##--X
XX-@X-oX
X-X--XXX
XXXXXXXX
