XXXXXXXX
XX---XXX
XoX--XXX
X----XXX
Xo#@-XXX
X-#----X
X---oXXX
XXXXXXXX
