XXXXXXXX
XXXXXX-X
X-X-XX-#
X-@-XoXX
XX-----X
X--##--X
X-----oX
XXXXXXXX
