XXXXXXXX
XX--X--X
X--o-XXX
Xo-----X
XX--##-X
X-o--@-X
X--X---X
XXXXXXXX
