XXXXXXXX
XXXXX-oX
X-o----X
XX--##-X
X-XX---X
XX-X--XX
X--XX@XX
#XXXXXXX
