XXXXXXXX
XX-o---X
X-X-X#-X
X-XXX@-X
X---X-XX
XXX--#-X
XXXo---X
XXX@XXXX
