XXXXXXXX
X-X--X-X
XX--X-XX
XX-X--oX
Xo-----X
XX-#-#-X
X-@----X
#XXXXXXX
