XXXXXXXX
X-@---XX
XXXX-#XX
XX--#X-X
XX-#--XX
XX---o-X
XXoXXXXX
XXXXXXXX
