XXXXXXXX
X---oXXX
X-#XXX-X
X------X
X--#@XXX
Xo--XXXX
XXXXXX-#
XXXXXXXX
