XXXXXXXX
X----oXX
X-##---X
X--@-X-X
XX-X-XXX
X---oX-X
XXXXX@-X
XXXXXXXX
