XXXXXXXX
XX---XXX
XoX--XXX
X-----XX
X-#-#-XX
X---X@X#
XXXo---X
XXXXXXXX
