XXXXXXXX
X---XX-X
X-o---XX
X-@-#--X
X--#--XX
X-XX-oXX
X-#XXXXX
XXXXXXXX
