XXXXXXXX
XXX-XX-X
XXoXXX@X
X--@-#-X
X--#-XXX
X-X----X
Xo-X-XXX
XXXXXXXX
