XXXXXXXX
XXX-XX-X
XXoXXX@X
X----#-X
X--#-XXX
X-X----X
@o-X-XXX
XXXXXXXX
