XXXXXXXX
X--XXX-X
XXX-XX-X
X--XX-XX
X-o--@-X
XX--##-X
Xo--o--X
XXXXXXXX
