XXXXXXXX
X--XXX-X
XX-----X
XX--#-XX
XXX#--XX
X@---oXX
X-X--XXX
XXXXXXXX
