XXXXX@XX
X----o-X
X-@#--XX
XX-#--XX
XXX--XXX
XXXXo--X
X--X-XXX
XXXXXXXX
