XXXXXXXX
XXXX-XXX
X@X---XX
XXo----X
XXXX##-X
XX---X-X
X--@--oX
XXXXXXXX
