XXXXXXXX
XXXX-XXX
X-X---XX
XXo----X
XXXX#o-X
XX---X-X
X--@--oX
XXXXXXXX
