XXXXXXXX
X-@-XX-X
X---X--X
X-#-X@-X
X-#---XX
X----o-X
Xo-XXXXX
XXXXXXXX
