XXXXXXXX
X---@X-X
X-#-X-XX
X-#-X-XX
X---#X-X
XoXXX-XX
XX---XXX
XXXXXXXX
