XXXXXXXX
XXXXX--X
X----o-X
X---X--X
XX@-#-XX
XX--#-XX
X-----oX
XXXXXXX#
