XXXXXXXX
X-XX-X-X
X-XX--XX
XXo---XX
XX-X#XXX
XX-#---X
X----o-X
XXXXXXXX
