XXXXXXXX
X@---X-X
X-@-XXXX
X--#---X
Xo---o-X
XX-XXX-X
X--X---X
XXXXXXXX
