XXXXXXXX
XX-o---X
X--XX--X
XX---#-X
X-X@#--X
XX-X--oX
XXX--X-X
XXXXX@XX
