XXXXXXXX
XXo-XX-X
XX----oX
X--#@--X
XX-----X
XX-----X
XX-@---X
XXXXXXXX
