XXXXXXXX
X@---XoX
X-o-#--X
XXXX-#-X
XXXo---X
XXXXXXXX
X----XXX
XXXXXXXX
