XXXXXXXX
XXX-XXXX
X#X@---X
XX--#--X
XX-#---X
XX-XXXoX
XXoXXXXX
XXXXXXXX
