XX#XXXXX
X---oX-X
X-#---XX
X--#--@X
Xo--X-XX
XXXX-X-X
XXXXXXXX
XXXXXXXX
