XXXXXXXX
XX---X-X
X--@--oX
XoX-#-XX
XX--#--X
XXo---XX
XX----XX
XXXXXXXX
