XXXXXXXX
X-o@---X
XX--X#-X
X---#--X
X-XX--oX
XX--XX-X
X--XXXXX
XXXXX#XX
