XXXXXXXX
XoX---oX
X---#--X
X---X#XX
X--X--@X
X----XXX
XXX-XXXX
XoXXXXXX
