XXXXXXXX
X----oXX
XX-#--XX
X---#XXX
XXo@-XXX
XXo-X-XX
X---XX-X
XXXXXXXX
