XXXXXXXX
X--XX-oX
XX-#---X
X-XX-#-X
X-X-X--X
X---o--X
X-X-XX-X
XXXXXXXX
