XXXXXXXX
XXX---oX
XX--#--X
X--@#--X
XXX---XX
X-X-X-XX
@X--Xo-X
XXXXXXXX
