XXXXXXXX
Xo----XX
X--##-XX
XX----XX
X-X@X#XX
XXX--XXX
X-XX-XXX
XXXXXXXX
