XXXXXXXX
XX-o---X
XXX--#-X
XXXX-#-X
XX----@X
X--Xo--X
XXX#-XXX
XXXXXXXX
