XXXXXXXX
XX---@oX
XX-#---X
X@-#---X
XXXXXoXX
XXX--X-X
XX-X-XXX
XXXXXXXX
