XXXXXXXX
X-XXXX-X
X-X--o-X
X-o---XX
X-X-#-#X
X-X#--XX
X---@XXX
XXXXXXXX
