XXXXXXXX
X-@X--XX
X-----oX
X---#--X
XXX##--X
XXX---XX
XXXXXoXX
XXXXXXXX
