XXXXXXXX
X--o---X
XX-X-#-X
XX--#--X
XX---X-X
X---#-oX
XX-X@X-X
XXXXXXXX
