XXXXXXXX
XXX---@X
XX-X---X
X---##-X
XXo----X
XXXXX-oX
XXX---#X
XXXXXXXX
