XXXXXXXX
XXXXX-XX
XoXX-X#X
X--#-XXX
X---#-@X
X-o-X-XX
X-X-XX-X
XXXXXXXX
