XXXXXXXX
X-X-XXXX
X-o-X--X
XX---o-X
XX-#-X-X
XX-#--XX
X---X@XX
XXX@XXXX
