XXXXXXXX
XX----XX
X-XX-oXX
X-o-@-XX
XX--#-XX
XX-#---X
XX@--XXX
XXXXXXXX
