XXXXXXXX
XXo----X
XX-X@X-X
XX-X#X#X
XX-#-XXX
XX---XXX
XXX--oXX
XXXXXXXX
