XX@XXXXX
XXXX--XX
X----@oX
XX--#--X
X--XX#-X
XXXo---X
XX-XX--X
XXXXXXXX
