XXXXXXXX
X-X----X
XXXX-@XX
X-Xo---X
X-X--#-X
X-X##--X
XX--X-oX
XXXXXXXX
