XXXXXXXX
XX-XoXXX
X-XX-XXX
XXXX-#-X
XXXo---X
XXX-X#-X
XX-X--XX
XXXXXXXX
