XXXXXXXX
XX-X-X-X
Xo-----X
X--##-XX
X@X@X--X
X---Xo-X
XXX--X-X
XXXXXXXX
