XXXXXXXX
XXX---XX
X--oXXXX
X-o-XX-X
X-X-#--X
X---#--X
XX@---oX
XXXXXXXX
