XXXXXXXX
X-X----X
XXX-X--X
X----oXX
X----@XX
XX-##-XX
XX-----X
XXXXXXXX
