XXX#XXXX
XXXXX@-X
XXXXX--X
XXo----X
X--X#-XX
XX-#--XX
X----oXX
XXXXXXXX
