XXXXXXXX
XXXXXX-X
X-XXXXXX
X@--oXXX
X-#XXX-X
X--#--XX
XoX---@X
XXXXXXXX
