XXXXXXXX
XoXXXX-X
X-----oX
X-##XX-X
X-----XX
o---X--X
XXXXX@-X
XXXXXXXX
