XXXXXXXX
X-XXXXXX
XX-o-XXX
X----XXX
X@#@--XX
X-#--X-X
X--Xo-XX
XXXXXXXX
