XXXXXXXX
X-X-@--X
XX-#--XX
X-X-#XXX
XXo--XXX
X-X--oXX
XXXXXXXX
oXXXXXXX
