XXXXXXXX
XXX@-XXX
XXX-X--X
XX---#-X
X---#--X
X@oX-XoX
XXX-XXXX
XXXXXXXX
