XXXXXXXX
X-X-XXXX
X-XoXX-X
XXX-@o-X
X-X#---X
X---#-XX
X-o---XX
XXXXXXXX
