XXXXXXXX
X-X-XX-X
XX-----X
XoX-@X-X
X--#X--X
X-#-X--X
X--Xo-XX
XXXXXXXX
