XXXXXXXX
X-XX-X-X
X----X-X
X--#X--X
XX--#-@X
XXo---XX
X---X--X
XXXXXXXX
