XXXXXXXX
X-oX-XXX
X@---X-X
X-##-X-X
X----oXX
XoXXX--X
XXXX-XXX
XXXXXXXX
