XXXXXXXX
X--o---X
X---X#-X
X-X@#-@X
XX--X--X
XX-X-XoX
XX-----X
XXXXXXXX
