XXXXXXXX
XXX-XX-o
X--oXXXX
XX----oX
XX--#--X
XXX--#XX
X-XXX@-X
XXXXXXXX
