XXXXXXXX
XXo----X
XX-X##-X
XXXX@--X
XXXXoXoX
X----XXX
X-----XX
XXXXXXXX
