#XXXXXXX
X-X---oX
XXX-#-XX
XXo----X
XX-X-#-X
X-XX-@XX
X-XXXXXX
XXXXXXXX
