XXXXXXXX
Xo---oXX
X--#---X
X-#---XX
X--@-XXX
XX-X--XX
XXXXXXXX
XXXXX@XX
