XXXXXXXX
XX-----X
XXXX-@oX
XX--#--X
X----#-X
XX-#---X
X--XXXXX
XXXXXXXX
