XXXXXXXX
XX@XXX-X
X---oXXX
XX#--XXX
X--#-XXX
X---XXXX
X---o-XX
@XXXXXXX
