XXXXXXXX
X---oX-X
o-#-X--X
X@#-X--X
XX----XX
XXXoXXXX
X-X-XXXX
XXXXXXXX
