XXXX#XXX
X-XX---X
X-XX@#-X
XXX--X-X
X---#--X
X-X--XoX
X-XoX-XX
XXXXXXXX
