XXXXXXXX
X-@o-XXX
XXXX-XXX
XXXX#--X
XXX--#-X
XXXo---X
X-X-XXoX
XXXXXXXX
