XXXXXXXX
X-XX-XXX
X----o-X
X-##X--#
X-@--oXX
XXX-XXXX
XXX-X--X
XXXXXXXX
