XXXXXXXX
X---X-XX
X-o----X
XXXX##-X
X@-#--XX
X----oXX
XXX---XX
XXXXXXXX
