XXXXXXXX
XXXXX-XX
Xo----XX
X@----oX
X-##-X-X
X----oXX
XXX---XX
XXXXXXXX
