XXXXXXXX
XXo-XX-X
X---XX-X
X--#@-XX
X---#XXX
XX----oX
XX---XXX
#XXXXXXX
