XXXXXXXX
XXXX-X-X
XX-XXo-X
X-o----X
XXXX#-XX
XXX-#--X
X-#---XX
XXXXXXXX
