XXXXXXXX
X--X-Xoo
X--@#--X
X-X-#--X
XX-----X
X-X--oXX
XXXXXXXX
XXXXXXXX
