XXXXXXXX
X---@-X@
XX---oXX
XXX#--XX
X---#-XX
X-o---XX
X---X--X
XXXXXXXX
