XXXXX#XX
X---o-XX
X-#-XX-X
X---X--X
X--#@--X
Xo---X-X
XXX--XXX
XXXXXXXX
