XXXXXXXX
X-X-X--X
Xo----XX
XXX##-XX
X@--X-XX
X----o-X
o-XX---X
XXXXXXXX
