XXXXXXXX
X-X---XX
XXX--@-X
X-XX#-XX
XXXX-#XX
XXXo@--X
XXXX--oX
XXXXXXXX
