XXXXXXXX
XXX--X-X
X-XXX@XX
XXXo---o
XXX-X#XX
XXX-#-XX
XXX---oX
XXXXXXXX
