XXXXXXXX
XX-#oXXX
X----X-X
X--#---X
X-#-@X-X
X-XX---X
XoXXX--X
XXXXXXXX
