XXXXXXXX
X-X-XX-X
X--@--oX
XX--#o-X
XX---#-X
X--XX--X
X-XXX-oX
XXXXXXXX
