#XXXXXXX
Xo--XXXX
X-----XX
X-#X---X
X-#--XXX
X-X--XXX
Xo@--XXX
XXXXXXXX
