XXXXXXXX
Xo--XXXX
X-----XX
XX#X---X
X-#--XXX
X-X--XXX
Xo@--XXX
XXXXXXXX
