XXXXXXXX
XX---@-X
XX--X--X
XXoX---X
X---#-XX
X-@#-XXX
XX---o-X
XXXXXXXX
