XXXXXXXX
X-XX--@X
X-X@-#-X
XXXX#-XX
X-XX--oX
XXXo--XX
XX-----X
XXXXXXXX
