XXXXXXXX
XX-XX-XX
XXXoX-@X
X----#-X
@---#X-X
X-X---oX
X-----XX
XXXXXXXX
