XXXXXXXX
XXX---oX
X-X-#--X
X--X-#-X
X-@--X@X
XX---XoX
X-X----X
XXXXXXXX
