XXXXXXXX
XXXX--oX
XX-@#--X
XXXXX--X
X----#-X
XX-o---X
X-oX-X-X
XXXXXXXX
