XXXXXXXX
XX-X--oX
XX@@#--X
X----#-X
X-X----X
XXXXXXoX
XX-XXXXX
XXXXXXXX
