XXXXXXXX
X---oXXo
X-#--XXX
X--#---X
Xo@--X-X
XX-XXXXX
XX--X-XX
XXXXXXXX
