XXXXXXXX
X--XXX-X
Xo-XXX-X
X--@XX-X
X-##XX-X
X----X-X
XX--oX#X
XXXXXXXX
