XXXXXXXX
X-----oX
X--@#--X
X-X-#-XX
X----oXX
XXXXXo-X
XX-XXXXX
XXXXXXXX
