XXXXXXXX
XX-X#X-X
XXo----X
XX--##-X
XX--@--X
X-X---oX
XX-XXX-X
XXXXXXXX
