XXXXXXXX
X----XXX
XX-#--XX
@--X--oX
XXo---XX
XX---#XX
XXX-X-@X
XXXXXXXX
