XXXXXXXX
XX-XXXXX
X--@XX-X
X-----XX
X-#@-XXX
X----oXX
XoXXX-XX
XXXXXXXX
