XXXXXXXX
XXXXX--X
Xo----XX
X--#---X
XX@#--XX
XX--XoXX
X-X-XXXX
XXXXXX@X
