XXXXXXXX
X@----XX
X-----XX
X-#-X--X
X-X-#X-X
X-----oX
XXXo--XX
XXXXXXXX
