XXXXXXXX
Xo-----X
X--##--X
XX---@-X
XXo----X
X---XX-X
X--XXo-X
XXXXXXXX
