XXXXXXXX
XXXXXX-X
Xo--XXXX
X---oX-X
X-#--XXX
X#-#X--X
XX@-XX-X
XXXXXXXX
