XXXXXoXX
XXX-X--X
Xo-X-XXX
X---o-XX
X-#XXX@X
X-#----X
X--X-X-X
XXXXXXXX
