XXXXXXXX
XX----oX
X-@-#-XX
X--#--XX
X--XXoXX
XXX-XX-X
XXXX--XX
XXXXXX@X
