XXXXXXXX
XX-X-#XX
XXo-XXXX
XX----oX
XX-##X@X
XX-----X
XXXXX-XX
XXXXXXXX
