XXXXXXXX
#--@--XX
X-##-XXX
X------X
XoXXoX-X
XXXXXX-X
X-X-X-XX
XXXXXXXX
