XXXXXXXX
X--X-XXX
X----oXX
X-#---XX
X---#@-X
X-X-X-XX
XX-----X
XXXXXXXX
