XXXXXXXX
XXo---XX
X-X-#@XX
XXX-#-XX
X---X--X
XXooX--X
XXXX-XXX
XXXXXXXX
