XXXXXXXX
X-X--XoX
X---#--X
X--@-#-X
X------X
XX-o-@XX
X-XXXXXX
XXXXXXXX
