XXXXXXXX
XX-o--XX
XXX----X
XX--##-X
XX@X@X-X
XXXX-XoX
X--XX-XX
XXXXXXXX
