XXXXXXXX
XXX#-@XX
XXX---XX
XX-----X
XXX-##-X
X-o----X
X-X---oX
XXXXXXXX
