XXXXXXXX
X-XXXXXX
XX@-#--X
XX-#---X
X---#--X
X-o--XoX
XX---X-X
XXXXXXXX
