XXXXXXXX
X------X
X-XX---X
Xo-----X
X--##--X
X-Xo-XoX
X-X@XX-X
XXXXXXXX
