XXXXXXXX
X@X-oXXX
X-#--XXX
XX-#---X
XX----oX
XXX--X-X
XX---X-X
XXXXXoXX
