XXXXXXXX
XX--XXoX
Xo----@X
XXX-#--X
X-X#X--X
X---XX-X
XX--@--X
XXXXXXXX
