XXXXXXXX
XXXXX-XX
XXXo-XXX
XX----oX
XXX-#--X
XXX--#-X
XXX-@--#
XXXXXXXX
