XXXXXXXX
Xo---XoX
XX---X-X
X---@#-X
X--XX#-X
XXX----X
X-----oX
XXXXXXXX
