XXXXXXXX
XXo---XX
XXX-#--o
X-X-#-@X
XXX-XXXX
X--o-XXX
XX-XXXXX
XXXXXXXX
