XXXXXXXX
X----X-X
XX-XXX-X
XXoX@--X
X---#--X
X--#--XX
XoX---XX
XXXX@XXX
