XXXXXX@X
XXXX--XX
X-o-X@XX
XX--#--X
XX-X#--X
Xo-----X
XXX--XXX
XXXXXXXX
