XXXXXXXX
Xo---oXX
X--#-XXX
X---X-XX
XX#XX-XX
XX@XX-X#
X--X-X-X
XXXXXXXX
