XXXXXXXX
X---XXXX
XX--X-XX
XXo---#X
XX--##-X
XX-----X
XX-X@XoX
XXXXXXXX
