XXXXXXXX
X--X--XX
X-#---XX
X-#X@-@X
X---o-XX
Xo-XXXXX
X-XXXXXX
XXXXXXXX
