XXXXXXXX
X-Xo--XX
X-XX--oX
X-XX#--X
X-XX-#XX
X-XX--Xo
XX-XX@XX
XXXXXXXX
