XXXXXXXX
Xo--XXXX
X--#--oX
X---#--X
X-oX-X-X
XXXXXX-X
X-XX--XX
XXXXXXXX
