XXXXXXXX
Xo---oXX
X--#-X-X
X-#-X-XX
X--@X#-X
XX--X-XX
XXXXX--X
XXXXXXXX
