XXXXXXXX
X-X--XXX
X-XXXXXX
X-X-o-XX
X@#---Xo
X--#-X-X
XX---o-X
XXXXXXXX
