XXXXXXXX
X----X-X
XX-X--XX
Xo-X-XXX
X--#---X
X-#-X--X
X---o-XX
XXXXXXXX
