XXXXXXXX
XXX-@XXX
XXX---oX
X-@-#--X
X------X
X-XX-#-X
XXXo---X
XXXXXXXX
