XoXXXXXX
XXXXX-XX
XX-XoX-X
XXX----X
XXXX-#-X
XXX--#-X
XXXo--@X
XXXXXXXX
