XXXXXXXX
XXXXXXoX
XXo----X
X-XX##-X
XX-@---X
X-XXX--X
XXX-X--X
XXXX#XXX
