XXXXXXXX
XX-----X
X-X--o-X
X@-----X
XX-##--X
X-----XX
XX---oXX
oXXXXXXX
