XXXXoXXX
X---XXXX
XXX-XXXX
X---oX-X
X-#-@-XX
X--#---X
Xo---X-X
XXXXXXXX
