XXXXXXXX
XX---oXX
X--#--XX
X--X#--X
XXo@-XXX
XXXXX-XX
X---XX-@
XXXXXXXX
