XXXXXXXX
Xo-XX-XX
X----o-X
X--#---X
X-@-X--X
XX-@XX-X
XXXXX--X
XXXXXXXX
