XXXXXXXX
XXX-XXXX
X-XX--@X
XXXX--oX
XX--#--X
XX-X-#-X
X--o---X
X#XXXXXX
