XXXXXXXX
oX-----X
XX---oXX
X--#-XXX
XX--XXXX
XX--#--X
XXoXXX@X
XXXXXXXX
