XXXXXXXX
XX@-X-XX
XXo----X
XX-X#--X
XX@#--XX
XXX--oXX
XX-XXXXX
XXXXXXXX
