XXXXXXXX
XX-XXXXX
XX-o-oXX
X-X----X
X@#-#-@X
XX----XX
XX----XX
XXXXXXXX
