X@XXXXXX
XXo----X
X---@--X
XX-#-XXX
XX-#---X
XX---XXX
X-o--XXX
XXXXXXXX
