XXXXXXXX
XXXXXXXX
X-XXXX-X
X---oXXX
X-#---XX
X--#-XXX
XoXX--@X
XX@XXXXX
