XXXXXXXX
X--@X--X
XX-#--XX
X---XX-X
X-#-X-XX
X@--oX-X
XoX--X-X
XXXXXXXX
