XXXXXXXX
XX-XoXXX
X--X--XX
XXX#-#-X
X--X-#-X
X--o---X
X---X-@X
XXXXXXXX
