XXXXXX@X
XX-X-X-X
XX----@X
XX-#---X
X--#-X-X
XX---o-X
XXoXXXXX
XXXXXXXX
