XXXXXXXX
X@--X--X
X-X-Xo@X
X--#X-XX
XX--#-XX
X-o----X
XXXXXXXX
XXXXXXXX
