XXXoXXXX
X----XXX
X@#-XXXX
X-#---XX
X---oX-X
XoX-X-XX
XX-XXX-X
XXXXXXXX
