XXXXXXXX
XXX--o-X
XXX---XX
XX--##-X
X@-X#-XX
X--X---X
X-Xo---X
XXXXXXXX
