XXXXXXXX
XXXX--oX
X-X----X
XXX###XX
XXX---XX
X--oX@-X
X--XX-XX
XXXXXXXX
