XXXXXXXX
XXXX---X
XX-X-#-X
XXXX-@oX
X-XX#X-X
XXX--#-X
X-Xo---X
XXXXXXXX
