XXXXXXXX
XXX-X-XX
XoXXXX-X
X---XX-X
X-#@-XXX
X-#X---X
X---@XXX
XXXXXXXX
