XXXXXXXX
X--X-XXX
XoX--XXX
X---@oXX
X--#---X
X-o-X--X
X---X--X
XXXXXXXX
