XXXXXXXX
X-XXXXXX
XXo-@XXX
XX---XXX
X@-#---X
X--#--XX
Xo---XXX
XXXXXXXX
