XXXXXXXX
X-XXXXXX
XXo-@XXX
XX---XXX
XX-#---X
X--#--XX
Xo---XXX
XXoXXXXX
