XXXXXXXX
X-X--oXX
Xo-----X
XXX##-XX
XX@----X
XX---oXX
X----XXX
XXXXXXXX
