XXXXXXXX
XX-X-X-X
X-----XX
X-X---oX
X-X-#-XX
XXX-X#-X
XXXo@@XX
XXXXXXXX
