XXXXXXXX
XXXoX--X
XXXXX#-X
XXXX-@XX
XXX-#XXX
X-X---oX
XX-X-XXX
XXXXXXXX
