XXXXXXXX
X---@-XX
o--#---X
Xo---XXX
X--#---X
X-----XX
X-XXoXXX
XXXXXXXX
