XXXXXXXX
X-XX-X-X
XXo----X
X---#--X
X--#--XX
Xo-X@XXX
XXXXXX-X
@XXXXXXX
