XXXXXXXX
XXX@X--X
XXX--#-X
XXX----X
XX---#-X
X-----@X
XXXXo--X
XXXXXXXX
