XXXXXX#X
X----X-X
X-X@-oXX
XX-----X
XX--#-XX
XXX-#--X
X-X---oX
XXXXXXXX
