XXXXXXXX
X-X---oX
XXXX---X
X-XX@#-X
X@X--#-X
X------X
XX-Xo--X
XXXXXXXX
