XXXXXXXX
X-X-XX-X
XX-oX--X
Xo---XXX
X----oXX
X-##-XXX
X---@-XX
XXXXXXXX
