XXXXXXXX
XX-X-oXX
Xo----XX
XX###--X
XX-----X
X-@-XXXX
XXXXX-XX
XXXXXXXX
