XXXXXXXX
XXXXXXXX
X---o--X
Xo----XX
XX-#-X-X
X-#----X
X----X-X
XXXXXXXX
