XXXXXXXX
X---@X-X
X-##--XX
X----oXX
XoXX---X
XX---X-X
X--X--XX
XXXXX@XX
