XXXXXXXX
#X-o--XX
XX---@oX
XXXX#--X
XXX--#-X
XX-XX--X
XXXXX--X
XXXXXXXX
