XXXXXXXX
Xo-----X
X---X--X
X-#-XX-X
X@-#-XXX
Xo@--XXX
X--X-XXX
XXXXXXXX
