XXXXXXXX
XXXXXX-X
XXX-XXXX
XXXX-@oX
X--X-X-X
X-@-##-X
XXo----X
XXXXXXXX
