XXXXXXXX
X-XXXXXX
XX--X-XX
XoX---XX
X----o-X
X-##XXXX
X---@-oX
XXXXXXXX
