XXXXXXXX
X-XXX#XX
XX--X-XX
XoX---XX
X----o-X
X-##XXXX
X---@-XX
XXXXXXXX
