XXXXXXXX
XX----oX
o---#--X
XX-#---X
XX@-XoXX
XX--XXXX
XXX----X
XXXXXXXX
