XXXXXXXX
XXX--XXX
XXXX-X-X
XoX---XX
X--#@--X
X--#---X
Xo--XXXX
@XXXXXXX
