XXXXXXXX
XX---oXX
XXX---XX
XX-##-XX
X-@----X
X---XX-X
XXX---XX
XXXXXXXX
