XXXXXXXX
XXXX-X-X
XoXXXXXX
X#X-XXXX
X-#@X--X
X-#-X--X
X---o--X
XXXXXXXX
