XXXXXXXX
XXXXXXoX
X-X@#--X
X--X-#-X
XXXo---X
XXXX--oX
XXX--XXX
XXXXXXXX
