XXXXXXXX
X-----XX
X-#----X
XX@-#--X
X--X---X
XX--XoXX
X--XX-XX
XXXXXXXX
