XXXXXXXX
X@----XX
XX----#X
XX-#--XX
X-#--XXX
X---oXXX
Xo--X-XX
XXXXXXXX
