XXXXXXXX
Xoo--X-X
X---o--X
XX#---XX
X--#-XXX
X---@X-X
X-X-XX-X
XXXXXXXX
