XXXXXXXX
X---o--X
X-#@--XX
X--#--XX
Xo-X-XXX
XX---XXX
XX-X--@X
XXXXXXXX
