XXXXXXXX
X--oX-XX
XXX---XX
@-X-#-@X
X-X----X
X-X--#-X
XXXoXXXX
XXXXXXXX
