XXXXXXXX
X--XX-XX
XXXXXXoX
XX--XX-X
X----#-X
X--XX@-X
X-@o---X
XXXXXXXX
