XXXXXXXX
XXX---XX
X-XXX--X
XX-@-XoX
X--#X--X
X------X
Xo-----X
XXXXXXXX
