XXXXXXXX
XXXX--XX
X-o-o@XX
X--X---X
XX--#-XX
XX-#---X
Xo----XX
XXXXXXXX
