XXXXXXXX
XX-XXXoX
X-X--@-X
XXX--#-X
X----#-X
X------X
XXXXo--X
XXXX#XXX
