XXXXXXXX
XoXXX-XX
X---XX-X
X-#--X-X
X----oXX
X--#XXXX
XXX@--XX
XoXXXXXX
