XXXXXXXX
X-@--XXX
XX-##-XX
X-----oX
X-o--XXX
X-X-X--X
X-XX---X
XX@XXXXX
