XXXXXXXX
X-XXXXXX
XXX----X
Xo---oXX
#--#--XX
X---#-XX
X-X@---X
XXXXXXXX
