XXXXXXXX
X---oXX@
X-#--X-X
X@-#-XXX
XX-X-X-X
XX--oXXX
XX-X-XXX
XXXXXXXX
