XXXXXXXX
XX---X-X
X-----XX
X----XXX
X-##-@XX
X----oXX
XoXX--XX
XoXXXXXX
