XXXXXXXX
X-X---X#
XXXX--oX
X--X-X-X
XX--#--X
X--#---X
X--@XoXX
XXXXXXXX
