XXXoXXXX
XXX----X
XXXX-XXX
XXX---oX
X-XX@X-X
X---##-X
X-o----X
XXXXXXXX
