XXXXXXXX
X-XXXXXX
X-o-XX-X
XX-o-XoX
X----X-X
X@#--#-X
X---X--X
XXXXXXXX
