XXXXXXXX
X@---X-X
X-#--X-X
X--XX-XX
X-X-oXXX
X-#XXX-X
X---o-XX
XXXXXXXX
