XXXXXXXX
X-----oX
X---#-XX
XX--#--X
X#--X-XX
X----o-X
X--X-XXX
XXXXXXXX
