XXXXXXXX
X---oXXX
X-#-X--X
X--#-XXX
XoX-@-XX
XXXX--XX
XXX-X@XX
XXXXXXXX
