XXXXXXXX
XX-----X
X-----oX
XX-@@X-X
X---##-X
Xo-----X
XX-X---X
XXXXXXXX
