XXXXXXXX
XXXX--oX
Xo-----X
X--o-#-X
XX--X--X
XX@----X
XXX--X-X
XXXXXXXX
