XXXXXXXX
X--XX-Xo
XXXX-XoX
XXXo---X
X-X--#-X
XX@--#-X
XX-----X
XXXXXXXX
