XXXXXXXX
XXXXXXXX
XX-XX-XX
X-XX-@oX
X---#--o
X----#-X
X-Xo---X
XXXXXXXX
