XXXXXXXX
Xo---X-X
XX-#-X-X
X-#----X
XX-XoXXX
XX-XXXXX
XX-XX-XX
XXXXXXXX
