XXXXXXXX
XXX-X--X
X--@-XoX
XX--#--X
XXX-@#-X
X-X----X
XXXX--oX
XXXXXXXX
