XXXXXXXX
XoXXX-@X
X--#-X-X
X---#--X
oXo--XXX
X---X--X
XXXXXXXX
XXXXXXXX
