XXXXXXXX
XX--X-XX
X-XXX--X
XXX---oX
X---#-XX
X-#---XX
X-@XXoXX
XXXXXX#X
