XXXXXXXX
Xo@--X-X
X--##X-X
XX---XXX
X----oXX
X--@X-XX
XXXXXXXX
XXXXXXXX
