XXXXXXXX
XX-XXXXX
Xo--@XXX
X--#--XX
X-#--X-X
X--@-XXX
XoX-XXXX
XXXXXXXX
