XXXXXXXX
X-@---oo
XX--#--X
XXX-#--X
X----XoX
X-X--XXX
XX----XX
XXXXXXXX
