XXXXXXXX
X-X--oXX
XX---XXX
XX--#X-X
X-X@--oX
XX--#--X
XXXXX--#
XXXXXXXX
