XXXXXXXX
XXo-XXXX
XX-X-X-X
XX-#-X-X
X---@X-X
X--#-X-X
XoX-XX#X
XXXXXXXX
