XXXXXXXX
X---o-XX
X-#-@-XX
X--#--XX
XoX-XXXX
X-X-XoXX
XXXXXX-X
XXXXXXXX
