XXXXXXXX
XXo-XXXo
X-@--XXX
X--#-XXX
XX-#--XX
Xo---XXX
XX-X-X-X
XXXXXXXX
