XXXXXXXX
XX-XXXoX
X----X-X
X-X@-#-X
XXXX#--X
XXo----X
X-#XXXXX
XXXXXXXX
