XXXXXXXX
XX-XXXXX
X--XX-XX
X-#-@X-X
X-#--XXX
XoX-XXXX
Xo-oXXXX
XXXXXXXX
