XXXXXXXX
X-X-XX-X
XX----XX
X-X---oX
XXo-@-XX
XX--##-X
X-----@X
XXXXXXXX
