XXXXX#XX
X---XXoX
XXXo@--X
XXX--#-X
X-XX-#-X
XX-----X
XX-XX--X
XXXXXXXX
