XXXXXXXX
XXXXXoXX
X-o----X
X--X#-XX
X---#-XX
XX----XX
XX-@XXXX
XXoXXXXX
