XXXXXXXX
XX#XX--X
XXXXX--X
Xo--X-XX
XX---X-X
X-##X--X
X@---o-X
XXXXXXXX
