XXXXXXXX
Xo---XXX
X--#--XX
XX--@X-X
XX@#-X-X
XX--XXXX
XXo----X
XXXXXXXX
