XXXXXXXX
XoXXXX-X
X---o-XX
o-#--X-X
X----X-X
X--#@--X
XXX--XXX
XXXXXXXX
