XXXXXXXX
XXXX-@-X
X-Xo--XX
X-X--#XX
XX--#-XX
XX---ooX
XX-X-X-X
XXXXXXXX
