XXXXXXXX
XX-o--XX
X-XX--oX
XX-X#--X
XX-X-#XX
XX--@--X
XX-X--XX
XXXX@XXX
