XXXXXXXX
X---XX-X
XX-XXXXX
X-X-oXXX
XX@--X-X
X-##-X-X
X----o-X
XXXXX#XX
