XXXXXXXX
XXo-XXXX
X---#@-X
X--#---X
#----XXX
Xo-XXXXX
XX--XX-X
XXXXXXXX
