XXXXXXXX
XXXXX--X
XX-X@-XX
XX---#-X
X---#--X
X-XX--oX
XX-o-X-X
XXXXXXXX
