XXXXXXXX
XXXXXX-X
X-----oX
X-@o#--X
XX-#---X
XXXX-o-X
X--XX-XX
XXXXXXXX
