XXXXXXXX
XXX-XXXX
XX@--X-X
XXXXXXoX
X---#--X
X@-#---X
X--XXoXX
XXXXXXXX
