XXXXXXXX
XXX-XXXX
XXX--X-X
XXXXXXoX
X---#--X
X@-----X
X--XXoXX
XXXXXXXX
