XXXXXX#X
X-XXXXoX
XXo----X
XXXX##-X
XXX----X
XXX--XXX
X-XX-@XX
XXXXXXXX
