XXXXXXXX
XXX-o-XX
XXXX--XX
XXXX-XXX
XX-X-#@X
XXX--#-X
XX-o---X
@XXXXXXX
