XXXXXXXX
XXo----X
XX--##-X
XXXX#--X
XX-X@XoX
XXXXXXXX
XX-XX-XX
XXXXXXXX
