XXXXXXXX
X---oXXX
X-#--X-X
X--#--XX
Xo-X-@XX
X----XXX
XX-XXX-X
XXXXXXX@
