XXXXXXXX
XX----XX
XX@-XXXX
XXX#--XX
XXX-#--X
X-@---XX
X-X--o-X
XXXXXXXX
