XXXXXXXX
XX--@XXX
XX---XXX
XX#--X-X
Xo-#-XXX
Xo---X-X
XXX-oXXX
XXXXXXXX
