XXXXXXXX
XXX-XXXX
XXXo--oX
X-X----X
X--X-#-X
X-@-#--X
X-----oX
XXXXXXXX
