XXXXXXXX
XXX-XXXX
XXXX--o#
X-X----X
X--X-#-X
X-@-#--X
X-----oX
XXXXXXXX
