XXXXXXXX
XXX-XX@X
XXXX--oX
X-X----X
X--X-#-X
X-@-#--X
X-----oX
XXXXXXXX
