XXXXXXXX
X--X--XX
X-XXXo-X
X-----XX
XX-##-XX
XX-o-@XX
X-o----X
XXXXXXXX
