XXXXXXXX
X--X--XX
X-XXXo-X
X-----XX
XX-##-XX
XX-X-@XX
X-o----X
XXX#XXXX
