XXXXXXXX
XXXX-XXX
X--@X--X
X----X-X
X-##X-XX
XX---o-X
XoX-XX-X
XXXXXXXX
