XXXXXXXX
XXXXXX-X
X-X----X
XX--##-X
X-o----X
XX@-XXo#
XX-XXXXX
XXXXXXXX
