XXXXXXXX
X-@--XXX
XX-Xo-XX
X--X---X
XX##--XX
X-X--o-X
X----XXX
XXXXXXXX
