XXXXXXXX
X--XX-@X
X-X--#-X
XX--#-XX
XX----oX
XX-X--XX
XX-XXXXX
XXXXXXXX
