XXXXXXXX
Xo-o-o-X
X--#--XX
XX--#--X
XX----XX
X---@--X
X-XXXXXX
XXXXXXXX
