XXXXXXXX
XXo----X
X-X-#--#
XXX-#-@X
XX-----X
XX-o---X
XXX-XX-X
XXXXXXXX
