XXXX#XXX
X----X-X
X---X-oX
XXXo---X
X-X--#-X
X-X@-#-X
XXX----X
XXXXXXXX
