XXXXXXXX
X----oXX
X-o--XXX
XX--#-XX
X@X#---X
X---X-XX
X--XoXXX
XXXXXXXX
