XXXXXXXX
XX----@X
XX----oX
XXX-#-XX
XX---#XX
XX-o--@X
X-XXX--X
XXXXXXXX
