XXXXXXXX
XXX--XXX
Xo---XXX
X----X-X
X-##X--X
X--@X-Xo
Xo---XXX
XXXXXXXX
