XXXXXXXX
X-----oX
X--##--X
X--@-X-X
X-X-XX-X
XX--X-XX
X-XX---X
XXXXXXXX
