XXXXXXXX
XX--XX-X
X--X-@XX
Xo----XX
X-X#-XXX
X-#-X-XX
X---o-X#
XXXXXXXX
