XXXXXXXX
X-X--X-X
XXXX-X-X
XXo--X-X
X------X
XX-##-XX
X---@-XX
XXXXXXXX
