XXXXXXXX
XXXo-XXX
XX-----X
X-X-#-XX
X-X-#@XX
XX----oX
X-X----X
XXXXoXXX
