XXXXXXXX
XXX----X
XXXXXX-X
Xo-----X
XX-#@XXX
X-#---XX
X@--o-XX
XXXXXXXX
