XXXXXX@X
X----oXX
X--#---X
XX--#-XX
X-o@--XX
XX-XXXXX
XX---X-X
XXXXXXXX
