XXXXXXXX
X--XXX-X
XXXX---X
XX-----X
XX-@-#-X
XX--#--X
X-oXXXoX
XXXoXXXX
