XXXXXXXX
X--XXXXX
X-@-X-XX
X--XXXoX
X---#--X
X-XX-#-X
XX-o---X
XXXXXXXo
