XXXXXXXX
XX-XXXXX
XXXX--oX
XXXo-X-X
XXX--#-X
XX--#@-X
XXX--XXX
XXXXX@XX
