XXXXXXXX
XX--X@XX
XXX--#XX
X---#--X
XXX---#X
XX-o--XX
X-X---XX
XXXXXXXX
