XXXXXXXX
XXo-XX-X
XX---oXX
XX-#-XXX
X---#XXX
XXX--XXX
@XX@--XX
XXXXXXXX
