XXXXXXXX
X--XX-XX
Xo--X--X
#@-X-X-X
X------X
X-##XXXX
X----o-X
XXXXXXXX
