XXXXXXXX
X@----oX
X-#-#-Xo
X-----XX
X-Xo---X
XXX--XXX
X------X
XXXXXXXX
