XXXXXXXX
X---X-oX
Xo-----X
X@XX##-X
X------X
XXXXX-XX
XX-----o
XXXXXXXX
