XXXXXXXX
Xo----XX
X--##XXX
Xo----@X
X--X-XXX
XX---XXX
X-X-X-XX
XXXXXXXX
