X@XXXXXX
XXX-@-XX
XX-----X
XX-X#-XX
XXX--#XX
XX-o--XX
XXX---oX
XXXXXXXX
