#XXXXXXX
XX--X-XX
XXoXXXXX
XX----oX
X--#---X
XX---#-X
X---X-@X
XXXXXXXX
