#XXXXXXX
X---X-XX
X-XoX--X
X-X--XXX
X-X-#-XX
XXX-#@-X
XXo---XX
XXXXXXXX
