XXXXXXXX
X-o----X
XXX---XX
X--#---X
X-@--o-X
X----XXX
X---XXXX
XXXXXXXX
