XXXXXXXX
XXX--XXX
Xo-X@X-X
X--#-XoX
X--#-XXX
X----oXX
XXXX-XXX
XXXXXXXX
