XXXXXXXX
X--XX-XX
Xo---XXX
XX---oXX
X--#-X-X
X---#@-X
X--X@--X
XXXXXXXX
