XXXXXXXX
XXXXXX-X
X-----oX
X---#-XX
X---#--X
X--XX-XX
XX@XXo-X
XXXXXoXX
