XXXXXXXX
XXo---oX
XX--#--X
XX-#--XX
XX--@X-X
X--XX--X
X--XX@XX
XXXXXXXX
