XXXXXXXX
XX--XXXX
X-XX---X
X-XXXXoX
Xo-----X
XX-#-#-X
XX@---oX
XXXXXXXX
