XXXXXXXX
XX-XX--X
XXX--@XX
X---#--X
XXXX-#-X
X-Xo---X
XXXXX#oX
XXXXXXXX
