XXXXXXXX
X-X-XXXX
XXX-@-oX
XXXX-X-X
XXX--#-X
X-XX-#-X
XX-o---X
@XXXXXXX
