XXXXXXXX
XX---X-X
XX@--o-X
XX-#---X
X-X-#--X
XXXXX@oX
XXX-XX-X
XXXXXXXX
