XXXXXXXX
#XX---oX
XX----XX
XXX-##-X
XXX-X--X
X--oX--X
XXXXX@-X
XXXXXXXX
