XXXXXXXX
X-XX-XXX
XXXX-XXX
XX-Xo-XX
X@-X-X-X
X-##--#X
X----oXX
XXXXXXXX
