XXXXXXXX
XX-XX-#X
XXXX-@-X
X------X
X---##-X
Xo-----X
XX-X--oX
XXXXXXXX
