XXXXXXXX
X--@@XXX
X-X-X--X
XX---X-X
XX-##--X
X-----oX
XXoX---X
XXXXXXXX
