XXXXXXXX
X----XXX
X-o---XX
X-----oX
XX@##--X
X------X
X-X@X-XX
XXXXXXXX
