XXXXX#XX
Xo---X-X
XX-#---X
X--#-XXX
X--X@--X
XXo---XX
XX-X--XX
XXXXXXXX
