XXXXXXXX
X--X-X-X
X-XXX-XX
X---o--X
X-#--X@o
X----#-X
XoX-X-XX
XXXXXXXX
