XXXXXXXX
X----oXX
X-#-X--X
X-#-@X-X
X--XX--X
XoXXXXXX
X---X#-X
XXXXXXXX
