XXXXXXXX
X--XX-oX
X--X--@X
X----X-X
X-Xo##-X
XXo----X
X--X---X
XXXXXXXX
