XXXXXXXX
Xo--X-XX
X----XXX
X--XX-XX
X-#--X#X
X--#-@-X
Xo-X---X
XXXXXXXX
