XXXXXXXX
XXXo-@-X
XX---#-X
X-X--#-X
X-X----X
XX-X--oX
XX-oX-XX
XXXXXXXX
