XXXXXXXX
X--X--XX
XXX-Xo-X
X@-#---X
XX--#-XX
XX----XX
XXo---oX
XXXXXXXX
