XXXXXXXX
XXoX-@-X
X---#--X
X--#---X
XoXX--XX
X#-X-X-X
X-X--XXX
XXXXXXXX
