XXXXXXXX
X----@-X
X--##--X
XX----oX
XXoX--XX
XXX---@X
XXXXX--X
XXXXXXXX
