XXXXXXXX
X@---o-X
X-##-X-X
XX---oXX
Xo--X--X
XX---X-X
XXXX--XX
XXXXXXXX
