XXXXXXXX
XX-XX-XX
X-@-XXXX
X-##--XX
X----o-X
XoXXXX@X
XXXX--XX
XXXXXXXX
