XXXXoXXX
XXo---XX
XX--#--X
XX--#--X
XX-@--oX
X-XX-XXX
X-XXX--X
XXXXXXXX
