XXXXXXXX
XX-o---X
XX---#-X
X---#--X
X@XX--oX
X---X@-X
X---X--X
XXXXXXXX
