XXXXXXXX
X-X-o--X
X---X--X
XXX@X#-X
X--#X-XX
X-X----X
XXo----X
XXXXoXXX
