XXXXXXXX
XXXXX--X
XXoXX--X
XX-----X
X--#--@X
X-#-#-XX
Xo--XX-X
XXXXXXXX
