XXXXXXXX
XXXXX--X
XXo-#--X
X-----oX
XXX##-XX
X-X---XX
XXXX-@XX
XXXXXXXX
