XXXXXXXX
XX---oXX
X@-#XXXX
X-#XX-XX
X---oXXX
XXX---XX
XXX-XXXX
XXXXXXXX
