XXXXXXXX
Xo----oX
X--##-XX
X----@-X
XXXo---X
XXXXX--X
XXXXXX-X
XXXXXXXX
