XXXXXXXX
X#Xo---X
X-X--#-X
XXXX-#-X
XXX--X-X
XXXX-X@X
XXXXo-XX
XXXXXXXX
