XXXXXXXX
X---oX-X
XX--X--X
X@-#XX-X
X-#-X-XX
X---oXXX
X---XX-X
XXXXXXX@
