XXXXXXXX
XX-XXX-X
X--@X-XX
X-#--X-X
X-#XXXXX
X----o@X
XoXX--XX
XXXXXXXX
