XXoXXXXX
X---X-XX
Xo--X--X
X-XXXX-X
X-@----X
X-##-X-X
X----oXX
XXXXXXXX
