XXXXXXXX
XX-oX--X
XXX--#-X
X-X--#@X
XXo--@-X
X-XX-X-X
XXXXXX-X
XXXXXXXX
