XXXXXXXX
XXXXX--X
X--X---X
X-o--#-X
X-X-#--X
X--X@#-X
XXXo---X
XXXXXXXX
