XXXXXXXX
XXX-XoXX
XXX-X-XX
XXXo#--X
X-X-#--X
X--@--oX
XXXXXX-X
XXXXXXXX
