XXXXXXXX
X-XXX-XX
XXX--X-X
X-o--#XX
XX--@X-X
XX-##X-X
XX----oX
XXXXXXXX
