XXXXXXXX
X-XX-X-X
XXXXXXo@
XX--#--X
X-X--#-X
X-o@---X
XXXX---X
XXXXXXXX
