XXXXXXXX
X-X---XX
XXX-XoXX
XX-#---X
X---#--X
X@-X-XoX
XX---X-X
XXoXXXXX
