XXXXXXXX
X--X-X-X
X-o---@X
X-X--#-X
XX--#--o
XXX-X-XX
X--oXXXX
XXXXXXXX
