X@XXXXXX
XXX--X-X
X--oX--X
X---XX-X
XX---#@X
X-X-#--X
X-o---XX
XXXXXXXX
