XXXXXXXX
XX---XXX
XoX-X-Xo
X-X@---X
X----XXX
X-##-X-X
X----oXX
XXXXXXXX
