XXXXXXXX
XXXXXXXX
XXX-oXXX
Xo---XXX
X--o-XXX
XX#---XX
X--@-XXX
XXXXXXXX
