XXXXXXXX
Xo---XXX
X--#-X-X
X-#----X
X-X--XXX
Xo--@XXX
XXXXX--X
XXXXXX@X
