XXXXXXXX
XX--XXXX
XXXXXXoX
XXo----X
XXXX##-X
XXX---oX
X-X@-X-X
XXXXXXXX
