XoXXXXXX
X-Xo--XX
XX--XX-X
X-X--X-X
X-X@#--X
X-X-#--X
XXXX-XoX
XXXXXXXX
