XXXXXXXX
X-----XX
XXX--X-X
X-@--oXX
XXX-X-XX
XX-#o-XX
XX----oX
XXXXXXXX
