XXXXXXXX
XX--o-XX
Xo--X--X
XX---X-X
XX##-XXX
X@-@-XXX
X---XXXX
XXXXXXXX
