XXXXXXXX
X-XX-XXX
X--XX-XX
X---X-XX
X---#-@X
X-#XX--X
X----o-X
XXXXXXXX
