XXXXXXXX
X----oXX
X--#X-XX
XX-#--@X
X-----XX
XXoX-XXX
XXXXXoXX
XXXXXXXX
