XXXXXX@X
X-X---oX
XXX-#--X
XX--#@-X
X-X----X
XX-oXX-X
X-X-XXXX
XXXXXXXX
