XXXXXXXX
XoXX--XX
X--#---X
X---#-@X
XXo--X-X
XXXXXXXX
XX#XXX-X
XXXXXXXX
