XXXXXXXX
X-X--@-X
X-X----X
o--XX#-X
XX-X---X
XX--#--X
XXo---oX
XXXXXXXX
