XXXXXXXX
XXXXXXXX
X-oXXXXX
X-o----X
XX-#@#-X
XX-----X
X-X--XoX
XXXXXXXX
