XXXXXXXX
XoXXX--X
X----oXX
X-##X--X
X-@-XXXX
X--XX@XX
XXXX-X-X
XXXXXXXX
