XXXXXXXX
Xo---XXX
#X-#@XXX
XX--#-XX
X-----oX
X--XXX-X
X--X-XXX
XXXXXXXX
