XXXXXXXX
X@XXX@XX
XXXXX-XX
XX---#-X
X-XX#-XX
XXX---oX
XXXo--XX
XXXXXXXX
