XXXXXXXX
XXXX-X-X
X-X@XXoX
XXXXXX-X
XXX@-#-X
X--X-#-X
X-Xo---X
XXXXXXXX
