XXXXXXXX
X--XX--X
XXo-XX-X
Xo--#@XX
X---#-XX
X-o---XX
XX---XXX
XXXXXXXX
