XXXXXXXX
XX-XXoXX
X@-#---X
X--#---X
XX---X-X
XXXXX-XX
XXXX-X-X
XXXXXXXX
