XXXXXXXX
X---X-X@
X-XX-oXX
XX-#--XX
XX-#--XX
X@-X--XX
X-XXoXXX
XXXXXXXX
