XXXXXXXX
XX-----X
XX-XXXXX
X---oXXX
X-#-X-XX
X-X#---X
Xo@---@X
XXXXXXXX
