XXXXXXXX
XX---X-X
XXXXX--X
X-@--XXX
X-##-X-X
X----oXX
XoXXX-X@
XXXXXXXX
