XXXXXXXX
XXXXXX-X
XXo----X
X---#@-X
X--#-#XX
Xo---XXX
X--XX-XX
XXXXXXXX
