XXX#XXXX
XX--X--X
X-oXX--X
XX--XX-X
X--X-@-X
XX-##--X
Xo----XX
XXXXXXXX
