XXXXXXXX
X---XX-X
XX---X-X
XX-@--#X
X--##--X
XX-----X
X----o-X
XXXXXXXX
