XXXXXXXX
X--XXXXX
X---o-XX
XXX----X
X-X--#@X
XX-X-#@X
X--o---X
XXXXXXXX
