XXXXXXXX
XXX-X-XX
X-XXX-XX
X-@@oXXX
XX---XXX
X-##--XX
X----oXX
XXXXXXXX
