XXXXXXXX
XXX-X-XX
X-XXX-XX
X-@XoXXX
XX---XXX
X-##--XX
X--@-oXX
XXXXXXXX
