XXXXXXXX
Xo--@X-X
X--#---X
X--#-XXX
XXXX-X-X
XXX-oX-X
X@-XXX-X
XXXXXXXX
