XXXXXXXX
X----X-X
X-#@X#XX
X----o-X
X-#--XXX
X--XXXXX
XoXX--XX
XXXXXXXX
