XXXXXXXX
X@----XX
X--#--XX
X@-#---X
X-X--X-X
X-o--XXX
X--XoX-X
XXXXXXXX
