XXXXXXXX
X-----oX
XX--#--X
XXo@---X
X--X-#-X
XX---@XX
XXX--X-X
XXXXXXXX
