XXXXXXXX
XXXX-XXX
X-XXXXoX
X-X-#--X
XX---#-X
XX@-#--X
XXXX-XoX
XXXXXXXX
