XXXXXXXX
X---o-XX
X-----XX
X----X-X
X----#@X
X-XX-#-X
X--o---X
X#XXXXXX
