XXXXXXXX
X--X-XXX
X-#@-XXX
X-##-X-X
X-----oX
XoXXXXXX
XXXX-X-X
XXXXXXXX
