XXXXXXXX
X-----oX
X---#--X
X-X@#-XX
XX-X--XX
X--XX-XX
X---X--X
XXXXXXXX
