XXXXXXXX
Xo-X-X-X
X--#-XXX
X-#-@-XX
X-X-o-XX
X--X---X
XX-X-XXX
XXXXXXXX
