XXXXXXXX
XX-X-XXX
XXXXoXXX
X@---XXX
X--#---X
X-##--XX
X--XXoXX
XXXXXXXX
