XXXXXXXX
XX--oXXX
X---X-XX
X--#X--X
X--#@XXX
X-o-X--X
XXoXX-XX
XXXXXXXX
