XXXXXXXX
X-XXXXXX
X-Xo---X
XXX--#-X
X-X@-#-X
X--X-X-X
XX-XXXoX
XXXXXXX#
