XXXXX#XX
XXXo---X
X-X-X@-X
X---#-XX
XX-----X
XXX-#XXX
XX----oX
XXXXXXXX
