XXXXXXXX
XX---X-X
#X--Xo-X
X@-#---X
X-#---XX
XXX-o--X
X---XXXX
XXXXXXXX
