XXXXXXXX
XX-oXX-X
XX--XX-X
X-#---XX
X-#--XXX
X@-XoXXX
XXXXXX-X
XXXXXXoX
