XXXXXXXX
Xo--XXXX
X----XXX
X-#X--XX
X-#-o-XX
X-----XX
Xo--@XXX
XXXXXXXX
