XXXXXXX#
Xo--XXXX
X----XXX
X-#X--XX
X-#---XX
X-----XX
Xo--@XXX
XXXXXXXX
