XXXXXXXX
XXXoXXoX
X-X--#-X
X----#-X
X-o---@X
XXX-X--X
X-X----X
XXXXXXXX
