XXXXXXXX
XXXoXXXX
X-X--#-o
X----#-X
X-o---@X
XXX-X--X
X-X----X
XXXXXXXX
