XXXXXXXX
X-X-X--X
XX--X-oX
X-Xo---X
X--X---X
X-X-##-@
XXXX-@-X
XXXXXXXX
