XXXXXXXX
XX---XXX
XXo---XX
XXX-#-XX
XX-#Xo-X
X---Xo-X
XX-@X-XX
XXXXXXXX
