XXXXXXXX
XX-#---X
Xo----XX
X--#---X
XX@#--XX
XXXX-XXX
X-X-oXXX
XXXXXXXX
