XXXXXXXX
XX--X--X
X@#---XX
XXX--XXX
X---#X-X
XXX---oX
XX@oXX-X
XXXXXXXX
