XXXXXXXX
X-XoX-@X
XX---#-X
XX--#-#X
XXo----X
X-XXXXXX
X------X
XXXXXXXX
