XXXXXXXX
XX-o-XXX
XXX----X
XXX-#-@X
X---#--X
XXo----X
XX-XXXXX
XXXXXoXX
