XXXXXXXX
XXXX---X
X---oXXX
X-#----X
X@-#---X
X--XXoXX
#XXXX-XX
XXXXXXXX
