XXXXXXXX
X-XX-X-X
XXXo---X
XXXX-#-X
XXX--#@X
XX-X---X
XXXXo#-X
XXXXXXXX
