XXXXXXXX
XXX-@--X
XXX#-X-X
X-X-#-XX
XXo--XXX
XXX--oXX
XX--XX-X
XXXXXoXX
