XXXXXXXX
XX--oXXX
X-----X#
XX-#-XXX
X@-#--XX
X--X-XXX
X-XXoXXX
XXXXXXXX
