XXXXXXXX
XX-@X-XX
X----oXX
X@-#---X
X---#--X
XXX--XoX
XXX-XXXX
XXXXXXXX
