X@XXXXXX
X-X---oX
X-XX--XX
X-X-@#-X
X-X-#-XX
X-X---oX
X----XXX
XXXXXXXX
