XXXXXXXX
XX-XXXXX
XXXXX-XX
Xo-XXX-X
X@---oXX
X-##---X
X-@--XXX
XXXXXXXX
