XXXXXXXX
XXXo---X
X----#-X
X-XX#X-X
X-X@--oX
X--#-XXX
X--X-XXX
XXXXXXXX
