XXXXXXXX
X--@---X
X-XXX--X
X--Xo--X
X-#---XX
X--#-XXX
XX---o-X
XXXXXX@X
