XXXXXXXX
X--@-XoX
XX--#--X
X--X-#-X
XXXo---X
XX-X--XX
XXX-X-XX
XXXXXXXo
