XXXXXXXX
XX-XXX-X
Xo--XX-X
X--@--oX
X-##--XX
X---#X-X
X--XXXXX
XXXXXXXX
