XXXXXXXX
XXXXXXXX
XXXX---X
XXo#--XX
X---#-XX
XX-#--XX
X-@X-oXX
XXXXXXXX
