XXXXXXXX
X-X@X--X
XX---X-X
XX--#--X
X-X---oX
X--#--XX
#X---oXX
XXXXXXXX
