XXXXXXXX
XoX-@-XX
X-X--X-X
X-##-XXX
X----o-X
X---XX-@
X-X---XX
XXXXXXXX
