XXXXXXXX
X-X--XXX
XoXXXX-X
X-XX-X-X
X-#-X-XX
X##--X-X
X@--oXXX
XXXXXXXX
