XXXXXXXX
X-----oX
XX-##--X
XX-X@--X
XXoXX-XX
XXX--XXX
XoXXX--X
XXXXXXXX
