XXXXXXXX
X--XX-XX
XX-XXXXX
XoX-X-XX
X-----oX
X--##-XX
X--X--@X
X#XXXXXX
