XXXXXXXX
Xo---XXX
XX-#-X-X
XX#X--XX
#--X-XXX
X--@o-XX
XX----XX
XXXXXXXX
