XXXXXXXX
X---oXXX
X-#XXXXX
X-#@-XXX
X---XXXX
XoXXXX-X
XXX-XX-X
XXXXXXXo
