XXXXXXXX
XXo---oX
XX#-#--X
XXX--#-X
XX-X-@-X
XX--XXXX
X-X---XX
XXXXXXXX
