XXXXXXXX
X----@XX
X-#-XX-X
X--#-X#X
Xo-----X
X---oXXX
XXXX--XX
XXXXXXXX
