XXXXXXXX
XX-XXXXX
XX-X-oXX
XXX--@XX
X--##-XX
Xo----oX
XXX-XXXX
XXXXXXXX
