XXXXXXXX
X-XXX--X
XXXo-X-X
Xo--#-@X
XX---#-X
XX#----X
X---XX-X
XXXXXXXX
