XXXXXXXX
XX-----X
#o----XX
XX-#--XX
XX#--XXX
X---oXXX
X@-XX-XX
XXXXXXXX
