XXXXXXXX
X---XX-X
XXXoX--X
X-X-X@XX
X-X-##XX
XX-----X
X-o----X
XXXXXXX#
