XXXXXXXX
XXXXXX-X
X-X-Xo-X
X-#--X-X
X---#--X
X-----oX
XX@X-XXX
XXXXXXXX
