XXXXXXXX
X---@oXX
X-#--XXX
X--#--XX
Xo-XXoXX
X-X-XXXX
XXXXXXXX
XXXXXXXX
