XXXXXXXX
XX--X--X
Xo-X-X-X
X-----XX
X-##---X
X---X-XX
X-X@XXXX
XXXXXXXX
