XXXXXXXX
X----oXX
Xo-#--XX
X-#----X
X---o-XX
XX-XXX-X
XXXXX--X
XXXXXXXX
