XXXXXXXX
X-X-X--X
X--@-#-X
XXXX-#-X
XXXo---X
XXX-#-oX
X-XXXX-X
XXXXXXXX
