XXXXXXXX
X--X--XX
X---#-XX
X--#--XX
X@XX@o-X
XXX-X-XX
XXXXX--X
XXXXXXXX
