XXXXXXXX
X--o--XX
X-X--XXX
X---#-@X
XXX--#-X
XXXo---X
XXX-X--#
XXXXXXXX
