XXXXXXXX
X--o--#X
X-X--XXX
X---#-@X
XXX--#-X
XXXo---X
XXX-X--X
XXXXXXXX
