XXXXXXXX
XXXXXX-X
X-XXXX-X
Xo-o@XXX
X----#@X
X-#--XXX
X---XXXX
XXXXXXXX
