XXXXXXXX
X-XX-@XX
X-X--#XX
@X--#--X
X-----oX
X--o-XXX
XXXXXXXX
XXXXXXXX
