XXXXXXXX
XX-XXXXX
XXXXX@XX
XXXoX--X
XXo-X-XX
X-X-##-X
XXo----X
XXXXXXXX
