XX@XXXXX
XXXo---X
XX-X-#-X
X--X@#-X
X--X---X
XXX-X-oX
X--X--XX
XXXXXXXX
