XXXXXXXX
XX-XXXXX
X---oXXX
X-#-XXXX
X--#-XXX
Xo----@X
XXX-XX@X
XXXXXXXX
