XXXXXXXX
XXX-XXXX
X-#X-XXX
XXX---oX
X-X-#--X
X-X--#-X
X--o@--X
XXXXXXXX
