XXXXXXXX
XXX-XXXX
X--X-XXX
XXX---#X
X-X-#--X
X-X--#-X
X--o@--X
XXXXXXXX
