XXXXXXXX
X-XX-XXX
XXXX@X-@
X-X--XoX
X---#--X
XXX--#-X
X-o----X
XXXXXXXX
