XXXXXXXX
XXXo---X
XX---#-X
X-X-#--X
X-XX-XoX
XXXo-XXX
XXX@--XX
XXXXXXXX
