XXXXXXXX
XXXXXX-X
Xo-X@-XX
X--#-XXX
X--#---X
Xo---X-X
XXXX-XXX
XXXXX@XX
