XXXXXXXX
#X-XXXoX
X--o---X
XX---#-X
X-XX@#-X
XXX----X
X--X---X
XXXXXXXX
