XXXXXXXX
XXX---oX
X-X----X
@X-X-#-X
XX---#-X
X------X
XX---@oX
XXXXXXXX
