XXXXXXXX
XX-o---X
XoX----X
X-X@XX-X
X-X----X
X-##X--X
X-----oX
XXXXXXXX
