XXXXXXXX
XXX-XXXX
XX@--oXX
X-##XXXX
X---XX-X
X---o-XX
X---X@XX
XXXXXXXX
