XXXXXXXX
XX---@-X
XXXX-X-X
XXo-#XXX
X---#XXX
X--#--XX
X----o-X
XXXXXXXX
