XXXXXXXX
XX---@-X
XXXX-X-X
XXo--XoX
X---#XXX
X--#--XX
X----o-X
XXXXXXXX
