XXXXXXXX
X--X--XX
X----oXX
X@-#-XXX
X-@----X
X---oXXX
XX-XXXXX
XXXXXXXX
