XXXXXXXX
XXXX-XXX
XX--XXXX
XoXX-XXX
X--@-XXX
X@#-#-XX
X-----oX
XXXXXXXX
