XXXXXX#X
X--XXX-X
X---o-XX
X-#-XXXX
X-#-XXXX
X@--XXXX
XXXoX--X
XXXXXXXX
