XXXXXXXX
XXo----X
X-X-#--X
X---@#XX
XX-----X
XXX---oX
XXXX-X-X
XX#XXXXX
