XXXXXXXX
XX--XXXX
X--X#-@X
X-X-#X-X
XXX#-X-X
XX---oXX
XXo--X-X
XXXXXXXX
