XXXXXXXX
X---XXXX
XX---oXX
XX--o--X
XX@#---X
X--#---X
X-X--o-X
XXXXXXXX
