XXXXXXXX
Xo---XXX
X--@-o-X
X-##--#X
X------X
X-X---XX
X--X-XXX
XXXXXXXX
