XXXXXXXX
X--X-XXX
XX@--o-X
@X##--XX
X-----XX
Xo---XXX
X--X-X-X
XXXXXXXX
