XXXXXXXX
XXo---XX
XX---o-X
@XX#---X
X-----XX
XX--#-XX
XX@--X-X
XXXXXXXX
