XXXXXXXX
Xo---X-X
X---#@-X
X---#-XX
XXoXXXX@
X---X-XX
XXXXXX-X
XXXXXXXX
