XXXXXXXX
X-@---XX
X--#-XXX
Xo----XX
XXX#---X
Xo---X-X
o-X-X-XX
XXXXXXXX
