XXXXXXXX
XoX--X-X
X------X
X-##@X-@
X-----oX
X-XXXXXX
XXXX-XXX
XXXXXXXX
