XXXXXXXX
XXX@-XXX
XXXX--XX
X--X---X
X--X##-X
XXo@---X
XXX--XoX
XXXXXXXX
