XXXXXXXX
X-----XX
X----#-X
X-X-#-@X
X---XXoX
X--o--XX
X--X-@XX
XXXXXXXX
