XXXXXXXX
X----oXX
X-#--X-X
XX--X-XX
XX-----X
XXX#-XXX
XXX@X--X
XXXXXXXX
