XXXXXXXX
X----XXX
X-@X-XXX
X--XoX-X
X-#---XX
X-X#-X-o
Xo---XXX
XXXXXXXX
