XXXXXXXX
X---XXXX
X-XX---X
Xo@XX--X
X---X--X
X-##--XX
X-----oX
XXoXXXXX
