XXXXXXXX
XXo-X-XX
XXoX---X
X----oXX
XX-#-X-X
XX--#--X
X--@-XXX
XXXXXXXX
