XXXXXXXX
X--#@XXX
XX---XXX
XX--#-XX
X--#---X
XX---oXX
XXoXXXXX
XXXXXXXX
