XXXXXXXX
X--XXXXX
X--XXXXX
X-Xo---X
X@-X@#-X
X---#--X
X----XoX
XXXXXXXX
