XXXXXXXX
X-XX---X
X--X-XXX
X-XXoXXX
X------X
X@##X-XX
X----oXX
XXXXXXXX
