XXXXXXXX
Xo--oX-X
XX----XX
X-##-X-X
oX@---XX
XX---XXX
XX-XXXXX
XXXXXXXX
