XXXXXXXX
X-XXXXXX
XXXXXX-X
X---oX-X
X-#--X-X
X--#-oXX
XoX---@X
XXXXXXXX
