XXXXXXXX
X-X--XXX
X---XXXX
X-XXoX-X
X-#---XX
X--#-XXX
X-@--o-X
@XXXXXXX
