XXXXXXXX
XXXo--XX
X--##@-X
X-----oX
X-o---XX
XX--XX-X
X-X--XXX
XXXXXXXX
