XXXXXXXX
XXo---XX
X-----oX
X--#--XX
X---X#XX
@--XX-@X
XXXXXXXX
XXXXXXXX
