XXXXXXXX
XXX-X--o
X--oX-XX
XXX-XX-X
X-----@X
X---##-X
XXo----X
XXXXXXXX
