XXXXXXXX
XX-X--@X
XX-XX-XX
XX-oX--X
X#X-X#XX
XX--#-XX
XX----oX
XXXXXXXX
