XXXXXXXX
XX-@-XXX
XX-X-X-X
XX-X-XoX
XX@-#X-X
X----#-X
XX-o---X
XXXXXXXX
