XXXXXXXX
XXo----X
XXX-X#-X
X-X--#-X
X-Xo--oX
X-X----X
XX-XXXXX
XXXXXXXX
