XXXXXXXX
X----o-X
X-##-X-X
X-X-X-XX
XoX----X
X-o-XXXX
X---@XXX
XXXXXXXX
