XXXXXXXX
XX-X---X
X-o----X
X-X-#@-X
XX-@---X
XXX-X-oX
X--XXXXX
XXXXXXXX
