XXXXXXXX
X-----@X
XX@-##-X
XXo----X
X-XXXXoX
X--XXXXX
XXXX-XXX
XXXXXXXX
