XXXXXXXX
XXX-XXXX
XXX-XX-X
X-X@#--X
XXXXX--X
XXXXX#-X
XXXo---X
XXXXXXXX
