XXXXXXXX
X-X--XXX
XX-X-oXX
XX-#---X
#X-#--XX
XX@XX-XX
X-oX---X
XXXXXXXX
