XXXXXXXX
X@X-oXXX
X-#--X-X
@XX#-X-X
Xo----XX
X--XXXXX
X--X---X
XXXXXXXX
