XXXXXXXX
X#--XXXX
X-XXX--X
XXo--@XX
X---#-XX
XX-#-XXX
X----oXX
XXXXXXXX
