XXXXXXXX
XXXXX-XX
X-XX--XX
XoXXX-XX
X--#-XXX
X-#-@XXX
X---o-X#
XXXXXXXX
