XXXXXXXX
X---X--X
X----oXX
X-X-X-XX
X---#--X
XoXXX@-X
XXXXXXXX
XXXXXXXX
