XXXXXXXX
X-@---@X
XX--#--X
X---#--X
X-----oX
XX-XXX-X
XXXX--XX
XXXXXXXX
