XXXXXXXX
XXX--XXX
XXXX---X
X---#--X
XX-#-@-X
XX---o-X
XXo--X-X
XXX@XXXX
