XXXXXXXX
XXX-XX-X
X-----XX
X-#@---X
X-#-X--X
X---oX@X
XoXXXXXX
XXXXXXXX
