XXXXXXXX
XXX--o-X
X-o---XX
XX--#-XX
XXX#-X-X
X-@---#X
XXXXXX-X
XXXXXXXX
