XXXXXXXX
XX-X-X-X
Xo--XX-X
X-X-XXXX
X-#---@X
X----#-X
X-ooXXXX
XXXXXXXX
