XXXXXXXX
X-X-X-XX
XXX--XoX
XXXo---X
X-X--#-X
X-X@#--X
X------X
XXXX@XXX
