XXXXXXXX
XXo--XXX
X---X--X
XX-#--@X
XX-#-@XX
Xo-----X
X-XXX--X
XXXXXXXX
