XXXXXXXX
XXXX-XXX
XXo----X
X--X#-XX
XX--#-XX
X--@X-X#
XXX--oXX
XXXXXXXX
