#XXXXXXX
Xo---X-X
X----o-X
X-##X--X
X---@-XX
XX----XX
X----XXX
XXXXXXXX
