XXXXXXXX
X----oXX
X-#-X--X
X-X#X--X
Xo--X-XX
XX----XX
X-@----X
XXXoXXXX
