XXXXXXXX
XXo@---X
XX--##-X
XX-----X
X-X-@-oX
XX-X-XXX
XXXXX--X
XXXXXXXX
