XXXXXXXX
X--XX-XX
Xo---XXX
X--#oXXX
X--#@--X
X-XX-XXX
XoX---XX
XXXXXXXX
