XXXXXXXX
X-----oX
XX-o--XX
X-XX-#-X
X-X-#-XX
XXX----X
X--XXXXX
XXXXXXXX
