XXXXXXXX
X@--XXXX
X----X#X
X-##X--X
X----oXX
Xo-XX-XX
XX-X---X
XXXXXXXX
