XXXXXXXX
X----oXX
X@-#--XX
X-#--X-X
XXXXo-XX
XXX#XXXX
X-XXX-XX
XXXXXXXX
