XXXXXXXX
XX-oX-@X
X----#-X
X-#--XXX
X--XXXX@
XoXXXXXX
XXXXXXXX
XXXXXXXX
