XXXXXXXX
XXXX---X
Xo-----o
X--##--X
X-X---oX
X-----XX
X-@-XXXX
XXXXXXXX
