XXXXXXXX
XXX-@-XX
XXXXX-XX
X-XX---X
XXXX-#-X
X--o---X
X--X-XoX
XXXXXXXX
