XXXXXXXX
XXX-XX-X
XXX-@XXX
X-----XX
Xo-##X-X
XX-----X
X-o--o-X
XXXXXXXX
