XXXXXXXX
X---o@XX
X-#--XXX
X--#X--X
XoX--@XX
X--X-X-X
XX-X--XX
XXXXXXXX
