XXXXXXXX
XX--o-XX
X----XXX
XXX#--XX
X--#-XXX
X-@X--XX
XX-XoXXX
XXXXXXX#
