XXXXXXXX
XXX---XX
oXX---oX
X-X-#--X
XXX--#-X
XXX-X@XX
X-Xo---X
XXXXXXXX
