XXXXXXXX
XX--o-XX
Xo--XXXX
X--#XXXX
X-#--X-X
X@-XXXX@
X---XXXX
XXXXXXXX
