XXXXXXXX
XXX-XXoX
XX-XX--X
X-----oX
XX--#-XX
X-@#--XX
X-XX-oXX
XXXXXXXX
