XXXXXXXX
XX--XX-X
XoXXo-XX
Xo---X-X
X--#---X
X-#----X
XX@--XXX
XXXXXXXX
