XXXXXXXX
XXX--X-X
X---oX-X
X-#-X-@X
X----#-X
Xo-XX--X
XX-XXX-X
XXXXXoXX
