XXXXXXXX
XXX-XX-X
XXXo-X-X
XX---X-X
X-#-X--X
X@##-X-X
X---o-XX
XXXXXXXX
