XXXXXXXX
XXoo-XXX
X----o-X
X--#-X-X
X-@-#--X
XXX----X
X--X--XX
XXXXXXXX
