XXXXXXXX
XXo----X
X---##-o
X-X-X-XX
X--o--XX
X-X@-X-X
X-XX---X
XXXXXXXX
