XXXXXXXX
X-XX-XXX
X-@-#-oX
X-#X--XX
XX---#-X
Xo----XX
XXXX---X
XXXXXXXX
