XXXXXXXX
XX---@XX
Xo-----X
X---##-X
XXo--@-X
X----X-X
X-XX---X
XXXXXXXX
