XXXXXXXX
XX-XXoXX
X--#--XX
X--X#-XX
X@o---XX
XX-XXX-X
X-@X--XX
XXXXXXXX
