XXXXXXXX
XXXX@XXX
XXX---oX
X--X-X-X
XX-X-@-X
X----#-X
X-Xo---X
XXXXXXXX
