XX@XXXXX
X@--X-XX
X-#-XXXX
X--#---X
Xo---XXX
XX--oXXX
XXXXXX-X
XXXXXXXX
