XXXXXXXX
X---oXXX
X-#XXX-X
XX--X--X
Xo---XXX
X-X#--XX
X-X-@--X
XXoXXXXX
