XXXXXXXX
XXXo-X-X
XXX-XXXX
X-#-X-XX
X@#-X-#X
X----XXX
Xo-----X
XXXXXXXX
