XXXXXXXX
XXXX--XX
XoXXXX-X
X---oXXX
X-#--X-X
X@o#-XXX
XXX--XXX
XXXXXXXX
