XXXXXXXX
X-----XX
X@X##--X
Xo----XX
XXX--oXX
X---XX-o
XXXX-X-X
XXXXXXXX
