XXXXoXXX
X---oX-X
X-#----X
X--#---X
X----XXX
XoX-@X-X
X-XX--XX
XXXXXXXX
