XXXXXXXX
X-XX-@XX
XX-XX--X
X--X---X
X--##-X@
X-----oX
XoX-XXXX
XXXXXXXX
