XXXXXXXX
XX---oXX
X--#--XX
X--#-#-X
XX-X--XX
XXo---@X
XX-XX--X
XXXXXXXX
