XXXXXXXX
XXXX-X-X
X-@---XX
X-#-XX#X
X---oXXX
X-#XXXXX
X---o-XX
XXXXXXXX
