XXXXXXXX
XXX-XX-X
Xo-----X
X----o-X
#-##-X-X
XX-@---X
XX-XXXXX
XXXXXXXX
