XXXXXXXX
X-X--X-X
X--oX-XX
XXX---@X
XX--##-X
XX-----X
XXo-X-oX
XXXXXXXX
