XXXXXXXX
XXX-XX-X
X---o--X
X-#---XX
X-X#---X
X-X#XXXX
Xo@----X
XXXXXXXX
