XXXXXXXX
X--X---X
Xo-X-XXX
X---o-XX
X-#@o--X
X-#--XXX
X----X-X
XXXXXXXX
