XXXXXXXX
XoX---oX
X--##XXo
X------X
XX-X@X-X
X--X-XXX
XXXXXXXX
XXXXXXXX
