XXXXXXXX
XoX---oX
X--##XXX
X------X
XX@X@X-X
X--X-XXX
XXXXXXXX
XXXXXXXX
