XXXXXXXX
XX@-XX-X
XX#----X
XX-#X@-X
X----o-X
Xo---X-X
XXXXXX-X
XXXXXXXX
