XXXXXXXX
Xo--oXXX
X-----XX
X@-#-X-X
X--#-XXX
X----oXX
XX-X-X-X
XXXXXXXX
