XXXXXXXX
XXXXX-XX
XXXXXXoX
XX-o---#
X----#-X
XX-X@#-X
X-XXX--X
XXXXXXXX
