XXXXXXXX
XXXoXX-X
XX-oX--X
X---#-@X
XXX-#-XX
XXo----X
XXX-X--X
XXXXXXXX
