XXXXXXXX
XX-XXXXo
X-X--XXX
X---@-XX
XX-##-XX
Xo-----X
X--X-o-X
XXXXXXXX
