XXXXXXXX
XXX-X--o
X-XXX-XX
X@---XXX
X---XoXX
X-##--XX
X-----oX
XXXXXXXX
