XXXXXXXX
X------X
Xo--XoXX
XX--o--X
X-#--XXX
X@-#-XXX
XXX--XXX
XXXXXXXX
