XXXXXXXX
X--X-XXX
#X-X-o-X
X-X@--XX
XXX##--X
XXX---XX
X-o----X
XXXXXXXX
