XXXXXXXX
X-XX-o-X
X--#--XX
X--X#-XX
X-oX--XX
X-@X--XX
X------X
XXXXXXXX
