XXXXXXXX
Xo-XXX-X
X----o-X
X-##--XX
X-@--XXX
X------X
X-XX-X-X
XXXXXX#X
