XXXXXXXX
XXX---XX
X-@#-X-X
X--#--XX
Xo---X-X
XXXXo-XX
XX-X-X-o
XXXXXXXX
