XXXoXXXX
X---@--X
XX-##--X
Xo----XX
X-XXXo-X
X-XXX-XX
X--X-XXX
XXXXXXXX
