XXXXXXXX
XXXXXXXX
X-X-X-XX
X-XoXXXX
X-XXX@-X
XXX-##-X
X-o----X
XXXXXXXX
