XXXXXXXX
XXo-X-XX
XX--#-XX
#---#--X
XX----XX
X-Xo-@XX
XXX--X-X
XXXXXXXX
