XXXXXXXX
XX---@-X
XX-o---X
XXX-X-XX
XX--#--X
XX--#oXX
XXo---XX
XXXXXXXX
