XXXXXXXX
X---XXXX
Xo-@XXXX
X--#---X
X-#-XX-X
@---o--X
X--XX--X
XXXXXXXX
