XXXXXXXX
XXoo---X
XX--#-XX
X@-#--XX
X--X-o-X
XX--XXXX
XX-XX-XX
XXXXXXXX
