XXXXXXXX
XXo----@
X-X-##-X
XXXX---X
XX--@XoX
XXXX---X
X-XXX-XX
XXXXXXXX
