XXXXXXXX
X-X-XXXX
X-XXXXXX
X-o---XX
XXX-#--X
XX-o--XX
XX@X-oXX
XXXXXXXX
