X#XXXXXX
X-X-X-XX
X-X--XXX
XXX-XoXX
X--#--XX
X--#--XX
Xo@----X
XXXXXXXX
