XX#XXXXX
X---XXXX
XXXXo-XX
X-@--XXX
X--X-XXX
X-##-X-X
X----oXX
XXXXXXXX
