XXXXXXXX
XX-X---X
Xo----XX
XX-#o--X
X-@--X-X
X--#X-XX
XX---oXX
XXXXXXXX
