XXXXXXXX
X-X----X
X-XX@#@X
XXX--#-X
XXXo---X
X-XXXXoX
XXX-XXXX
XXXXXXXX
