XXXXXXXX
Xo--@-XX
X--##-XX
X-----oX
X-X#-X-X
X---X-XX
XXX-XXXX
XXXXXXXX
