XXXXXXXX
o---o-XX
X-#-X-XX
XX--XX-X
X@#-XX-X
X-X--XXX
X-XoX-XX
XXXXXXXX
