XXXXXXXX
XX-@XX-X
XoX-XXXX
X--#--XX
X-X-X-XX
X-#--XXX
X---o-X#
XXXXXXXX
