XXXXXXXX
XXXXXXXX
X-X@X#XX
XX--XoXX
X-X#X-XX
XX--#--X
X-----oX
XXXXXXXX
