XXXXXXXX
X-XXXXXX
Xo--X-@X
X---#--X
X#-#--XX
Xo---XXX
XX-X--XX
XXXXXXXX
