XXXXXXXX
X-X--oXX
XXXo-X-X
XXX#-XXX
Xo---X-X
XXX-#XXX
XX--@-XX
XXXXXXXX
