XXXXXXXX
oXXX-XXX
XX---XoX
XX-o---X
XX-X-#-X
XXX-#--X
XX-@--XX
XXXXXXXX
