XXXXXXXX
XXX----X
X-XXX-XX
X--XXo-X
X@-#---X
X--#o--X
XX----oX
XXXXXXXX
