XXXXXXXX
X-XXX-oX
X-o----X
XX-X##-X
X#XX---X
X-XX@--X
X--X--XX
XXXXXXXX
