XXXXXXXX
X--XX-oX
XXXX-@-X
X-XX-#-#
X----#-X
X-Xo---X
XXX-X--X
XXXXXXXX
