XXXXXXXX
Xo-X---X
X--#@oXX
X-##---X
X----XXX
XX--X--X
XX-XXXXX
XXXXXXXX
