XXXXXXXX
X-X---XX
X----o-X
X-#XX@XX
X-#----X
X-----XX
XoXXXXXX
XXXXXX@X
