XXoXXXXX
X-X-XXXX
XX-XX-XX
XXo@--XX
X-----XX
XX-##XXX
XX----oX
XXXXXXXX
