XXXXXXXX
XXXXoX-X
X-@X-XXX
XX##-XXX
XX-X--XX
X----XXX
Xo---X-X
XXXXXX@X
