XXXXXXXX
XX-XX-oX
X-@-#--X
XXXXo--X
XXX-#X-X
XXX---oX
XXX-XXXX
XXXXXXXX
