XXXXXXXX
XX-XXXXX
X----o-X
X--#--XX
X-@--XXX
X--#-XX#
Xo---XXX
XXXXXXXX
