XXXXXXXX
X#X--XXX
XXX--X-X
Xo----oX
X---#--X
X-#----X
X-@X-XXX
XXXXXXXX
