XoXXXXXX
X-X-XXXX
XXX@-XoX
XX--#--X
X-X----X
X---#--X
XX----oX
XXXXXXXX
