XXXXXXXX
X-XXXXXX
X-XXXXXX
XXXo@--X
X-X--#-X
XXX-#--X
XX----oX
XXXXXX#X
