XXXXXXXX
X---X@XX
X--#--XX
X--#--XX
X----o-X
XXoX---X
X-XX-XXX
#XXXXXXX
