XXXXXXXX
XXX---oX
X-@-#-XX
X--#--XX
XX---oXX
X--XXXXX
XX-XX--X
XXXXXoXX
