XXX@XXXX
X---X-XX
Xo@----X
XXX##--X
X----XXX
XX---o-X
XX-XXXXX
XXXXXXXX
