XXXXXXXX
X---o-XX
X-#X---X
X----#@X
XoX--X@X
XXXXX--X
X-X-XXXX
XXXXXXXX
