XXXXXXXX
XXo---XX
X-XX#-XX
XX----oX
X-X-#--X
XXX--@XX
XX#XXX-X
XXXXXXXX
