XXXXXXXX
X---oX-X
Xo#---XX
X-#---XX
X@---XXX
XXXo--XX
XXX-XXXX
XXXXXXXX
