XXXXXXXX
XX-----X
X@X--#-X
X-#o---X
XX-XoXoX
XX-X-XXX
XXX-XXXX
XXXXXXXX
