XXXXXXXX
XX---oXX
X-----XX
XXX@#--X
XX--#-XX
X#XX--XX
XXX-Xo-X
XXXXXXXX
