XXXXXXXX
X--XoXXX
X-----XX
X-@@---X
XX-#--XX
XX---o-X
X-XX---X
XXXXXXXX
