XXXXXXXX
X-X-XXXX
XoX---XX
XXX--oXX
XX-----X
X@-##--X
Xo-----X
XXXXXXXX
