XX#XXXXX
XXXX-XXX
XXXX--XX
X@--o-XX
XX#--XXX
X--#--XX
X----o-X
XXXXXXXX
