XXXXXXXX
oX-XXX-X
XoXX--oX
X---#-XX
X--X-#-X
XXX----X
X---XX@X
XXXXXXXX
