XXXXXXXX
Xo--@X-X
X--#---X
X@#XXXXX
X---oXXX
XX---XXX
XX-XXXXX
XXXXXXXX
