XXXXXXXX
X----oXX
X--#-XXX
X@-#--XX
X--X---X
XX@-oXXX
X-X--X-X
XXXXXXXX
