XXoXXXXX
X------X
Xo-----X
X--#--XX
X----oXX
X-#X-XXX
XX@XX-XX
XXXXXXXX
