XXXXXXXX
XX-X-X-X
X----#@X
X-oX---X
X---#--X
X--#-X-X
XoXX-X-X
XXXXXXXX
