XXXXXXXX
XX-XXo@X
X----#XX
XX-#--XX
XX----oX
XXo-XXXX
XX-XXXXX
XXXXXXXX
