XXXXXXXX
X-X-X-XX
XXX-XX-X
XXoX---X
XX--#--X
XX-#-XXX
XX---oXX
XXXXXXXX
