XXXXXXXX
X-o--@-@
XX--#--X
X--#XXXX
XX---oXX
XXX----X
X-XXX--X
XXXXXXXX
