XXXXXXXX
XXX-X--X
XX-XX--X
X-o----X
XXX-##-X
XX-X---X
XXX-@-oo
XXXXXXXX
