XXXXXXXX
X---oXXX
X-#XXXXX
X---XXXX
XX---oXX
XX-#X-XX
XXX-@XXX
XXXXoXXX
