XXXXXXXX
XXX-XXXX
X--XXX-X
X-o---oX
XX-----X
XX-##--X
XXX-@--X
XX#XXXXX
