XXXXXXXX
XXo----X
XXX-#-XX
X@-#--XX
X-X----X
XX--@oXX
XXXX--XX
XXXXXXXX
