XXXXXXXX
X-@---oX
X---#--X
X@--#--X
XX-XX--X
X--XXo-X
X-XX-XXX
XXXXXXXX
