XXXX#XXX
X-Xo---X
XXX--#-X
X---#--X
X-X@X-oX
X-X-X--X
X-XXXX-X
XXXXXXXX
