XXXXXXXX
XX-o@--X
XX---#-X
X-X-X--X
X-o----X
XX-XXX-X
X-X---XX
XXXXXXXX
