XXXXXXXX
XXXo-XXX
X@--X--X
X-#-X-XX
XX--XXXX
X-#-XXXX
#---o-XX
XXXXXXXX
