XXXXXXXX
X--XXoXX
X------X
XX--#--X
XX-#@-XX
X---X-XX
X-o-#-XX
XXXXXXXX
