XXXXXXXX
Xo--X-XX
X---o--X
X-#XXX-X
X----XXX
XXX#XXXX
XXX@--XX
XXXXXXXX
