XXXXXXXX
X----oXX
X#---X-X
XX--#--X
X--#--XX
XX--XoXX
X----X-X
XXXXXXXX
