XXXXXXXX
X----o@X
X--#--XX
XX-X#XXX
X-o----X
XXX-@-XX
XXXXX--X
XXXXXXXX
