XXXXXXXX
XXXXXXXX
XX--XXoX
X-X-#-oX
X--#---X
X---@o-X
XXXXXXXX
XXXXXXXX
