XXXXXXXX
XX--X-XX
X---XX-X
X-@---oX
XX--#--X
X---#@-X
XX--X--X
XXXXXXXX
