XXXXXXXX
XXX----X
X-@-##-X
XX@----X
XXXXXXoX
X--X-XXX
XX--XXXX
XXXXXXXX
