XXXXXXXX
XXX@---X
X-X-##-X
XXX----X
X--o@-XX
X-----oX
XXXXX-XX
XXXXXXXX
