XXXXXXXX
XX---o-X
XX-#---X
X---#-XX
XX--@X-X
XXoX-XXX
XXX--X-X
XXXXoXXX
