XXXXXXXX
X-----oX
XXXo--XX
X--X-XXX
XXX-#--X
XX-X--XX
XX-X@X-X
XXXXXXXX
