XXXXXXXX
X---oXXX
X-#----X
X--#X@-X
Xo-----X
XXXXX--X
XXXXX--X
XXXXX#XX
