XXXXXXXX
o-X-X@XX
XX-X-#-X
X--X#--X
X-X---oX
XX----oX
X-XX--XX
XXXXXXXX
