XXXXXXXX
XXX----X
X--o-X-X
XoXX--XX
X-----oX
X-##-XXX
X--@-X-X
XXXXXXXX
