XXXXXXXX
XX----oX
XXX-##XX
X-@-#-XX
X--X--XX
XX--XoXX
X--X-X-X
XXXXXXXX
