XXXXXXXX
X----o-X
X-##-X-X
X----XXX
Xo-@oX-X
XXXX---X
XXX--XXX
XXXXXXXX
