XXXXXXXX
X-----oX
X-#-#--X
X@--X--X
X---Xo-X
X-XX-XXX
XX-X@-XX
XXXXXXXX
