XXXXXXXX
X-XXXXXX
X-@-oXXX
X-#XXXXX
X-#---XX
X-X-XXXX
Xo-@---X
XXXXXXXX
