XXXXXXXX
X@X---XX
Xo-----X
X--@XXXX
X-#--XXX
X--#-XXX
Xo---XXX
XXXXXXXX
