XXXXXXXX
XX-@--XX
X---#-XX
XX##-XXX
XXX--oXX
XXo---XX
XXX-XXXX
XXXXXXXX
