XXXXXXXX
XX-X-XXX
XXXo---X
X----#-X
XX--#--X
X@---#oX
XX-----X
XXXXXXXX
