XXXXXXXX
XoXXX-XX
X--@-oXX
X-#--X-X
X----XXX
XXXX#-XX
XXX@-XXX
XXXXXXXX
