XXXXXXXX
X-----oX
XXX-@X-X
X#X--#-X
XX--#--X
XXX---oX
XXX--XXX
XXXXXXXX
