XXXXXXXX
X-XX-XXX
X--XX-XX
XoX-XXXX
X--#---X
X---#--X
XXoX-@-X
XXXXXXXo
