XXXXXXXX
XX--XXXX
Xo@-XXXX
X-X---@X
X-##X-XX
X----o-X
X-XXXXXX
XXXXXXXX
