XXXXXXXX
Xo----oX
XX-##-XX
X-X---XX
XXX-@-XX
XXX-XXXX
XX-XX--X
oXXXXXXX
