XXXXXXXX
X-X---oX
XX--#XXX
XX-@--XX
XX-#-X-X
XX---o-X
XoX-X-XX
XXXXXXXX
