XXXXXXXX
XXX@X-XX
XXX-X-@X
X-oX---X
X---#X-X
XX-#---X
X----oXX
XXXXXXXX
