XXXXXXXX
XXX--XXX
XXX--X-X
X-----oX
XXo-o-XX
X---##-X
X-X---@X
XXXXXXXX
