XXXXXXXX
X-XXXXXX
Xo-----X
XXX##oXX
XX-----X
X-@--o-X
X---X--X
XXXXXXXX
