XXXXXXXX
X-XXXXXX
Xo-----X
XXX##-XX
XX-----X
X-@--o-X
Xo--X--X
XXXXXXXX
