XXXXXXoX
X---o-XX
X-#X@X-X
X--#---X
XoX----X
X-----XX
XX--X--X
XXXXXXXX
