XXXXXXXX
XXXX-XXX
X-oX@XXX
XXX--XoX
XXX-#X-X
XX---#-X
XXXo---X
XXXXXXXX
