XXXXXXXX
X-X-X-XX
X-X-XX-X
X-X-XoXX
XXX@--XX
XX-##--X
Xo-----X
@XXXXXXX
