XXXXXXXX
X---X-XX
Xo----@X
XXXX-XoX
XXX-#X-X
XXXX-#-X
X--o---X
XXXXXXXX
