XXXXXXXX
XX-X-XXX
XXXXo--X
X-X----X
X--#-#-X
#-----@X
XXo--XXX
XXXXXXXX
