XXXXXXXX
Xo--X-XX
X@--oXXX
X-#----X
XX-#-X-X
X--@--XX
XX-X--XX
XXXXXXXX
