XXXXXXXX
XX--o--X
X---XX-X
X--#-XXX
X------X
X-@---XX
XXXXoXXX
XXXXXXXX
