XXXXXXXX
X-X-@--X
X#-----X
XX--#X-X
X-X#--XX
XXX--o-X
XXo----X
XXXXXXXX
