XXXXXXXX
X-----oX
X--##-oX
XX-@X--X
XX-X-o-X
X---XX-X
X-XXX--X
XXXXXXXX
