XXXXXXXX
XX-XXX-X
X@---X-X
X--#-XXX
Xo---oXX
X--#---X
X--@XX-X
XXXXXXXX
