XXXXXXXX
XX-X-XXX
XX-o---X
XXXX-#-X
XXX##--X
X-X--XoX
XX-X@-XX
XXXXXXXX
