XXXXXXXX
XXo-X-XX
XX--#--X
X----#-X
XXXoX-@X
X------X
XX-XXXXX
XXX@XXXX
