XXXXXXXX
XoX--oXX
X--#-@XX
X---#-XX
X------X
X------X
X--XXXXX
X#XXXXXX
