XXXXXXXX
XXXXXXXX
X----o-X
XXXXX-oX
Xo-----X
XXX#-#-X
X---@--X
XXXXXXXX
