XXX@XXXX
XXXXXXXX
X----X-X
XXXXX-oX
Xo-----X
XXX#-#-X
X---@--X
XXXXXXXX
