XXXXXXXX
XXo----X
X-X-##-X
XXX---XX
X@-o@X-X
X-X-XX-X
X-XX-XXX
XXXXXXXX
