X#XXXXXX
XX-XX-XX
X-X-X-oX
XX---@-X
XX--##-X
XXo----X
X--XX--X
XXXXXXXX
