XoXXXXXX
X-XXXXXX
XXXoXX-X
XXX--XXX
X-#-XXXX
X@#---XX
X---o-XX
XXXXXXXX
