XXXXXXXX
#-Xo---X
X-XX-#-X
X-XX-#-X
XXXX-@-X
XX----oX
X-X--XXX
XXXXXXXX
