XXXXXXXX
X--XoXXX
XX-@-XXX
XXX#---X
XX--#--X
X-o---XX
XXXXXoXX
XXXXXXXX
