XXXXXXXX
X----oXX
X-#X---X
X-#XX--X
X-X@XXXX
Xo---XXX
X-----XX
XXXXXXXX
