XXXXXXXX
XX--@-XX
XoX---XX
X-X#-XXX
X-X-X--X
X-#-#-XX
X---oXXX
XXXXXXXX
