XXXXXXXX
X----XXX
X--@---X
X-#-XXXX
X--#X--X
X@---oXX
XX--XX-X
XXXXXXXX
