XXXXXXXX
Xo----XX
XX--#--X
XX--#-@X
XXo---XX
XXX-XX-X
XX-XX-XX
XXXX@XXX
