XXXXXXXX
X--XX--X
XXX---XX
X-@#---X
X--#--XX
Xo#--oXX
X-XXXXXX
XXXXXXXX
