XXXXXXXX
X@X--oXX
X-#----X
X--#--XX
Xo#XX-XX
X-X--X-X
XXX--X-X
XXXXXXXX
