XXXXXXXX
XX-@---X
XXX--X-X
X-X-X#-X
Xo-----X
X-XX-XoX
XX-X--XX
XXXXXXXX
