XXXoXXXX
X-XX-X-X
X-XoXX-X
X-X--@-X
X------X
XXX-##-X
XXo----X
XXXXXXXX
