XXXXXXXX
XXX-o--X
XXX--XXX
XXXX--oX
XX@#---X
X-X--#-X
XXX-X--X
XoXXXXXX
