XXXXXXXX
XXX-o-XX
X-----oX
XXX---XX
XX---#XX
X---o#@X
XXX--X-X
XXXXXXXX
