XXXXXXXX
XXX@--oX
X-X-#--X
X-X-#-XX
X-----#X
X-X---oX
X--X-XXX
XXXXXXXX
