XXXXXXXX
XX--X-oX
X-Xo---X
X-X--#-X
X--X-#-X
XX-----X
X-@--XXX
#XXXXXXX
