XXXXXXXX
X-XX-X-X
XX-X---X
XXX--#@X
XX-X-#-X
X----o-X
X-X-oXoX
XXXXXXXX
