XXoXXXXX
Xo-X---X
X--#@--X
X-#X---X
X---o--X
X------X
X-X--XXX
XXXXXXXX
