XXXXXXXX
XXXX---X
XX-X-#-X
XXX-#--X
#-XX-@oX
XXXo--XX
XXX-XXXX
XXXXXXXX
