XXXXXXXX
Xo----XX
XX---XXX
XX##--#X
X@---X-X
XX---X-X
XXXXo--X
XXXXXXXX
