XXXXXXXX
X---XXXX
XoXX-XXX
X--#XX@X
X---#--X
XXo--X-X
XX--XXXX
XXXXXXXX
