XXXXXXXX
X--XXX-X
XXX-XX@X
X-oXX--X
XX--#--X
XX---#-X
XXXo-X-#
XXXXXXXX
