XXXXXXX#
X--XXX-X
XXX-XX@X
X-oXX--X
XX--#--X
XX---#-X
XXXo-X-X
XXXXXXXX
