XXXXXXXX
XoXXXXXX
X@--oXXX
X-#-XXXX
X--#--XX
XX---XXX
X@--XXXX
XXXXXXXX
