XXXXXXXX
XXXXXX-X
#X-XXo-X
X@-#--XX
XX#X--XX
XX---XXX
Xo---XXX
XXXXXXXX
