XXXXXXXX
X-XX--XX
XX-XXX-X
XX-o-XoX
X-X----X
XX--##-X
X-----@X
XXXXXXX#
