XXXXXXXX
X-----oX
X-o-#-XX
X-@X---X
X---#-XX
X-X---XX
XXXX-oXX
XXXXXXXX
