XXXXXXXX
XX-X-X-X
XXX----X
X---oX-X
X-#----X
X#-#--XX
Xo--X-@X
XXXXXXXX
