XXXXXXXX
X-XX-oXX
X--X--XX
#X--#-XX
X--@#-XX
X-----XX
X----oXX
XXXXXXXX
