XXXXXXXX
X-XX-oXX
X--X--XX
XX--#-XX
X--@#-XX
X-----XX
X----oXX
XX#XXXXX
