XXXXXXXX
X-o-@--X
XX--#--X
XX-#---X
XXX--XoX
X-XX@--X
XXXXXX-X
XXXXXXXX
