XXXXXXXX
X@---oXX
XX---XXX
XX--#@XX
X-X-#--X
XX---XXX
X-Xo---X
XXXXXXXX
