XXXXXXXX
X-XXXX-X
XX-@--o#
XX-##-XX
X-----XX
X-oX---X
X-X--XXX
XXXXXXXX
