XXXXXXXX
X-XXX-XX
XX-#-oXX
X----@XX
XXX#--XX
XXX-#--X
XXo----X
XXXXXXXX
