XXXXXXXX
XX--X-XX
XXXXXXoX
XXXo--XX
X---X@XX
X-X-##-X
Xo-----X
XXXXXXXX
