XXXXXXXX
X-X--oXX
X-#--XXX
XX-#--XX
Xo----XX
XXXX---X
XXXXX-XX
XXXXXXXX
