XXXXXXXX
X--X---X
XX-@#--X
XX-X#--X
XXo----X
XX-XXo-X
X-X--oXX
XXXXXXXX
