XXXXXXXX
XXX--oXX
XX-#---X
X@--#--X
X-XXXXoX
XX---XXX
X-XX---X
XXXXXXX@
