XXXXXXXX
X-XXXX-X
X-oX-XXX
XX----oX
X--##XXX
XX-@--oX
XXX---XX
XXXXXXXX
