XX#XXXXX
XXXX--XX
XXX@-#-X
X-X-#-XX
XXX---oX
X--o--XX
XXXX-X-X
XXXXXXXX
