XXXXXXXX
XXXX--XX
XXX@-#-X
XoX-#-XX
XXX---oX
X--o--XX
XXXX-X-X
XXXXXXXX
