XXXXXXXX
XXXX--XX
X-X-XXXX
Xo-X--@X
X------X
X-##-@-X
X----o-X
XXXXXXXX
