XXXXXXXX
X-X-XX-X
X--o@--X
X---X--X
XXX-##-X
o-o----X
X----XXX
XXXXXXXX
