XXXXXXXX
XXXXXXXX
XXX-X-oX
XX--@--X
X-o----X
XXXX-#-X
X--X-@XX
XXXXXXXX
