XXXXXXXX
XX----XX
XX-o---X
X-#---XX
XX-#--XX
Xo----XX
XXX--oXX
XXXXXXXX
