XXXXXXXX
XoXXX-XX
X----oXX
X-#--X-X
X----XXX
XoXX#-XX
XXX@-XXX
XXXXXXXX
