XXXXXXXX
X---X-XX
X-----XX
X-----oX
XX-##X-X
XX--@X@X
XXoXX-XX
XXXXXXXX
