XXXXXXXX
XXo----X
XX--##-X
XXX-X@-X
XXXo---X
#X---XXX
X--X--XX
XXXXXXXX
