XXXX#XXX
X------X
X-X--XXX
XoX---XX
X--#@X-X
X-#----X
X----oXX
XXXXXXXX
