XXXXXXXX
XX-o-XXX
X---X@XX
X---#oXX
XX--#X-X
XX----oX
XXXXXXXX
XXXXXXXX
