XXXXXXXX
X----@-X
XXX-#--X
XXX--#-X
XXXo--XX
X--X---X
XXXX--XX
XXXXXXXX
