XXXXXXXX
X-@X-oXX
XX-#---X
XXXX#-#X
X--X---X
X------X
X-----oX
XXXXXXXX
