XXXXXXXX
XX---XXX
Xo--oXXX
X----XoX
X-##-X-X
X----X-X
XX--@--X
XXXXXXXX
