XXXXXXXX
X----oXX
X@o#X--X
X-----XX
Xo--X--X
XXXX-X-X
X---XX-X
XXXXXXXX
