XXXXXXXX
XXXX-X-X
X--@XXoX
X---#--X
X--#-#-X
X--o---X
XXX-XXXX
XXXXXXXX
