XXXXXXXX
XXX---oX
XXX-#--X
X--X-#-X
X---@X-X
X--X--oX
oX--XXXX
XXXXXXXX
