XXXXXXXX
Xo---XXX
XX@#-XXX
X--#--XX
XX---X-X
XX-XoX-X
X----XXX
XXXXXXoX
