XXXXXXXX
XX-X-X-X
X-oX-XXX
X---@X-X
XX-#-XXX
X--@-XXX
Xo---XXX
XXXXXXXX
