XXXXXXXX
XXXX-XXX
XXXX-XXX
#o-oXX-X
X-X-X-XX
X-#-#-@X
X----XXX
XXXXXXXX
