XXXXXXXX
X-X----X
X@-Xo-XX
X-#--XXX
X--#--XX
@X---oXX
X---X-XX
XXXXXXXX
