XXXXXXXX
X----XXX
XXX-XX-X
XX-X-ooX
XX-@---X
XX-#-#-X
Xo-----X
XXXXXXXX
