XXXXXXXX
Xo-----X
X--#---X
XX-#@X-X
XX--X-XX
XX-X-X-X
XXoXXX-X
XXX#XXXX
