XXXXXXXX
X---XX-X
X--@--XX
X---X-XX
X-#XX-XX
X----o-X
Xo-X--XX
XXXXXXXX
