XoXXXXXX
XXXXXXXX
X-o-XX-X
X-----oX
XX-##--X
X-----XX
X-@---XX
XXXXXXXX
