XXXXXXXX
XXXX-o-X
X--X--XX
XX-@#-XX
X-XX#--X
XX-----X
Xo----oX
XXXXXXXX
