XXXXXXXX
XXX-XXXX
XXo---XX
X-@-#-XX
X@-#--XX
X-XX-o-X
XXXXXXXX
XXXXXXXX
