XXXXXXXX
X---o-XX
X-#---XX
X-#--XXX
X@---XXX
#--oX--X
XXX-X--X
XXXXXXXX
