XXXXXXXX
X---o-XX
X-#---XX
X-#--XXX
X@---XXX
X--oX--X
XXXoX--X
XXXXXXXX
