XXXXXXXX
XX-oXXoX
Xo-----X
XXX#-#-X
XXX-X--X
XXX-XXXX
X--@XXXX
XXXXXXXX
