XXXXXXXX
XXXX---X
X-X-XXoX
X--@#--X
XXXX-#-X
XXXo---X
XX-X-X#X
XXXXXXXX
