XXXXXXXX
X-Xo---X
XX-X-#-X
X----#-X
X--X---X
XXXX-@oX
X-XXXX-X
XXoXXXXX
