XXX#XXXX
X-XXX-XX
Xo----XX
Xo---XXX
XX-#X-XX
X-#--X-X
X-@X-XXX
XXXXXXXX
