XX@XXXXX
X----oXX
XXo--X-X
XX--#X-X
X@-#-XXX
X---X-XX
X-X--XXX
XXXXXXXX
