XXXXXXXX
X--X--XX
XXXo---X
XXXX---X
XXX-##-X
X-----@o
X--X--oX
XXXXXXXX
