XXXXXXXX
XXXX--XX
@X---oXX
XX-#--XX
X@-#---X
XX---o-X
XXXX-XXX
XXXXXXXX
