XXXXXXXX
Xo---X-X
X----X-X
X-#@---X
X##XXX-X
X--X--XX
X--oX--X
XXXXXXXX
