XXXXXXXX
X-X@X--X
XX---#@X
X---#--X
XXoX---X
X-X----X
XXX---XX
XXXXXXXX
