XXXXXXXX
X@-----X
X----##X
XXXX-#-X
X-Xo---X
XX-X-XoX
XX-X-XXX
XXXXXXXX
