XXX@XXXX
XX---o-X
XX-#X@-X
X--#--XX
X------X
XXo--XXX
XXX-XX-X
XXXXXXXX
