XXXXXXXX
XX-X--XX
X-XX-#XX
XXo---oX
XX--#--X
X---X#-X
XXXX--@X
XXXXXXXX
