XXXXXXXX
Xo--XX-X
X---#-XX
X-#X--XX
X--#--XX
X----@XX
XoXX-XXX
XXXXXXXX
