XXXXXXXX
Xo--XX-X
X-----XX
X-#X--XX
X--#--XX
X----@XX
@oXX-XXX
XXXXXXXX
