XXXXXXXX
X--XX-oX
XXX-@X-X
X-X--#-X
X--X-#-X
o-Xo---X
XXXX---X
XXXXXXXX
