XX@XXXXX
XX-XXXXX
XXoXXXXX
X----oXX
XX-#-X-X
X--#@--X
X------X
XXXXXXXX
