XXXXXXXX
X--XXXXX
XXXX--XX
X@--XXXX
X--#---X
X--##-XX
Xo----oX
XXXXXXXX
