XXXXXXXX
X-X-@XoX
XXX-#--X
XXX--#-X
XX-o-#-X
XX--X-XX
X-XX-XXX
XXXXXXXX
