XXXXXXXX
XX----@X
X-XX---X
X---##-X
X-oo---X
XXXXX-oX
XXX-XX-X
XXXXXXXX
