XXXXXXXX
XXo--ooX
X---#--X
XX-#X--X
X-X@X-XX
XX-XX--X
X--X-XXX
XXXXXXXX
