XXXXXXXX
X--@XXXX
X-#--XXX
X--#-XXX
Xo---o-X
XXXXX--X
X-XXXX@X
XXXXXXXX
