XXXXXXX#
XX-XXX-X
XXXXXXXX
XXo--oXX
XXX----X
X--##-XX
XX@---XX
XXXXXXXX
