XXXXXXXX
@-XXX-XX
X@-XoXXX
X-#--XXX
XX#---XX
X-----XX
X----o-X
XXXXXXXX
