XXXXXXXX
XXXo--@X
XX-X-#-X
XXXX-#-X
XXXX-@-X
X-XXX-oX
X-X-XX-X
XXXXXXXX
