XXXXXXXX
XXX---oX
XX--#--X
XX---#XX
XX-o--XX
XX---@-X
X------X
XoXXXXXX
