XXXXXXXX
X-XX--XX
Xo-XX-XX
X----oXX
X-##--XX
X---@X-X
XXXX-X-X
XXXXXXX#
