XXXXXXXX
X-X---oX
X---#--X
oX--#@XX
XX--X-XX
XXo--XXX
X-XXX-XX
XXXXXXXX
