XXXXXXXX
XX-XX--X
X-XXX-oX
XX-XX--X
X--X--XX
X--##@XX
Xo----oX
XXXXXXXX
