XXXXXXXX
XX-XX--X
X-XXX-XX
#X-XX--X
X--X--XX
X--##@XX
Xo----oX
XXXXXXXX
