XXXXXXXX
X--XX-XX
XX-#---X
XXX-X#-X
X-X-#--X
X-X@X-oX
XX-XXXXX
XXXXXXXX
