XXXXXXXX
XXoX-X-X
XX-X-XXX
XX-#@XXX
X---#XX@
XX----oX
XX--X-XX
XXXXXXXX
