XXXXXXXX
X--XX--X
X----oXX
X--#@-XX
X--#-X-X
X----X-X
X-oXXo-X
XXXXXXXX
