XXXXXXXX
XXXXXX-X
XXXXXX-X
X-o----X
XX----oX
XX-##X-X
#X-@-X-X
XXXXXXXX
