XXXXXXXX
XX-----X
XX-@-#-X
XX--XX-X
XXo----X
XXXXX-oX
XX-XXXXX
XXXXXXXX
