XXXXXXXX
Xo--oX-X
X---X--X
X-X#-XXX
X-#@---X
X-----XX
XX--#--X
XXXXXXXX
