XXXXXXXX
XXXo---X
XXX--#-X
X-X--#-X
X-@----X
XXX-XXoX
X--XX-XX
XXXXXXoX
