XXXXXXXX
X-X--XXX
XX--#X-X
XXo---oX
XX-X#-XX
#XXX-@XX
XXXX--XX
XXXXXXXX
