XXXXXXXX
X-----oX
XX--#--X
X----#XX
XXX--@XX
X--X--XX
XXX-XXXX
XXXXXXXX
