@XXXXXXX
XXXX-XXX
XX-XXoXX
Xo-----X
XX-##-XX
X------X
X---@--X
XXXXXXXX
