XXXXXXXX
XXX-X-XX
X--@oXXX
XX#--X-X
X--#-XXX
X----X#X
XoXXXXXX
XXXXXXXX
