XXXXXXXX
XXX-X-XX
X--@oXXX
XX#--X-X
X--#-XXX
X----XXX
XoXXXXoX
XXXXXXXX
