XXXXXXXX
X-XXXX-X
X--XXXoX
X--o---X
@-X--#-X
XXX-#--X
XXX@---X
XXXXXXXX
