XXXXXXXX
XXXXX@-X
XXXX--XX
X-XX-#XX
X-XX#-XX
X-----oX
X-Xo--XX
oXXXXXXX
