oXXXXXXX
XX-XXXXX
X--XXX-X
X---oXXX
X-#-@XXX
X--#--XX
Xo-X---X
XXXXXXXX
