XXXXXXXX
XXX---oX
XX--#XXX
X----X-X
X----oXX
XX-#XX-X
XX--@XXX
X#XXXXXX
