XXXXXXXX
X-X---XX
X@--X--X
XXX##--X
Xo---XoX
XX---X-X
o---X-XX
XXXXXXXX
