XXXXXXXX
XXX-XX-X
XXX-XX-X
X-Xo--@X
XX---#-X
X#X-#--X
XXX---oX
XXXXXXXX
