XXXXXXXX
XX-X--XX
X--@##XX
XXX-#-XX
X-o---XX
X-X-Xo-X
XXXXX-XX
XXXXXXXX
