XXXXoXXX
X-X@--XX
XX---#-X
XX-o---X
XXXX-#-X
XX-X--XX
XX-XoX-X
XXXXXXXX
