XXXXXXXX
XX@o---X
#---X#-X
X---#--X
XXXXX-oX
XXXX-XXX
XX-X-XXX
XXXXXXXX
