XXXXXXXX
XXXXX-XX
X-XXX-XX
XXo--oXX
X--#--XX
X-#---XX
X@-XoXXX
XXXXXXXX
