XXXXXXXX
XXXXX-XX
X-XXX-XX
XX-@-oXX
X--#--XX
X-#---XX
X@-XoXXX
XXXXXXXX
