XXXXXXXX
X----o-X
X@-#---X
XX-X#--X
X-o---XX
X---XX-X
XX-X-#XX
XXXXXXXX
