#XXXXXXX
X-XXXX-X
X--X-XXX
X--X--oX
XXX-#--X
X-X@#--X
X-X---oX
XXXXXXXX
