XXXXXXXX
o--X--@X
XXXXX--X
XX-o---X
XXX--#XX
XXX-#--X
XXX---oX
XXXXXXXX
