XXXX@XXX
X----XXX
XX-X--oX
XX-#--XX
XX-XX#XX
XXoXX@XX
XXXXXXXX
XXXXXXXX
