XXXXXXXX
Xo-XXXXX
X----oXX
X-##-XXX
X--@X--X
X-X-X--X
@--XX-XX
XXXXXXXX
