XXXXXXXX
X@-----X
X-#-#XXX
XX----oX
XX-o--XX
XXXXXX#X
XXXXX-XX
XXXXXXXX
