XXXXXXXX
X--XXoXX
Xo--@--X
X@-##-XX
X------X
X---X--X
XXXX-XXX
XXXXXXXX
