XXXXXXXX
Xo-----X
X-----XX
X-#--XXX
X-#-@XXX
X---XXXX
Xo-XX@XX
XXXXXXXX
