XXXXXXXX
X--@-X-X
X-##---X
X-----oX
Xo-X-XXX
XX-X-X-X
X@--X--X
XXXXXXXX
