XXXXXX#X
X-X-XX-X
XX-X-XXX
XX-X-o-X
X--#---X
X@#----X
X---o--X
XXXXXXXX
