X#XXXXXX
X--X-XXX
X-XX-X-X
Xo---X-X
X--##--X
X-----XX
XXo@XXXX
XXXXXXXX
