XXXXXXXX
XXX-X-XX
XX-X-@XX
X--oX--X
XXX-X--X
X-X-##-X
XXo----o
XXXXXXXX
