XXXXXXXX
X--X--oX
XX--XXXX
XX---@oX
XX-##--X
Xo-----X
X---X--X
XXXXXXXX
