XXXXXXXX
X----@-X
X--##--X
Xo----oX
X-XXX--X
X-X-XX@X
XXXXX-XX
XXXXXXXX
