XXXXXXXX
XX@---XX
XXX#-XXX
@o-----X
X---o-XX
X-#-X-XX
X--X-XXX
XXXXXXXX
