XXXXXXXX
X-X----X
XX--@#-X
XXX-X#-X
X--o--#X
X-XX--oX
XXXX--XX
XXXXXXXX
