XXXXXXoX
X-oX--XX
X----#@X
X--#-X-X
Xo---X-X
XXX----X
XX--XXXX
XXXXXXXX
