XXXXXXXX
XXXXX-XX
XXXXXXoX
XXXo---@
X-XX-#-X
XXX-@#-X
XXX-X--X
XXXXXXXX
