XXXXXXXX
XXXX-XXX
X-X-@-XX
X-XX--oX
XX@----X
XX--##-X
Xo-----X
XXXXXXXX
