XXXXXXXX
X--oXX#X
X-X-XXXX
X-#-X-XX
X---oXXX
X-#----X
X--@-X-X
XXXXXXXX
