XXXXXXXX
XX--X#-X
XXo----X
X--X##-X
XX-X@--X
X--XX-oX
X-X-X--X
XXXXXXXX
