XXXXXXXX
X-XXXX@X
XXX-o--X
XXXX-X-X
XX-#-X-X
X-@#---X
X-----oX
XXXXXXXX
