XXXXXXXX
X-X@XX-X
Xo-----X
XXX##XXX
XX---XXX
X-X--oXX
XX---X@X
XXXXXXXX
