XXXXXXXX
XXXo---X
XXX----X
XX--##-X
XX---X-X
XXX@X@oX
XXXX-XXX
XXXXXXXX
