XXXXXX@X
XX@----X
XX#-X--X
XX-X--XX
XX-#--XX
Xo---oXX
XXX-X-XX
XXXXXXXX
