XXXXXXXX
XX----oX
X-X@#--X
X--@#--X
XX----XX
XX-X--XX
X--XXo-X
XXXXXXXX
