XoXXXXXX
X-oX--XX
X----#-X
X--#X-@X
XX----oX
XXXX---X
XX-XX--X
XXXXXXXX
