XXXXXXXX
X-----XX
X-@---XX
X-XX-#XX
X-XX#-XX
XXXX--oX
X-Xo--X#
XXXXXXXX
