XXXXXXXX
XXo--XoX
X---#--X
X---@#-X
X--X---X
XX----XX
XXX-XX-X
XXXXXX#X
