XXXXXXXX
XXo----X
XX--#--X
XXX--#@X
XXXoXX-X
XX-#--XX
X-XXXXXX
XXXXXXXX
