XXXXXXoX
XXo----X
XX--#--X
XXX--#@X
XXXoXX-X
XX-X--XX
X-XXXXXX
XXXXXXXX
