XXXXXXXX
XXXXXXXX
XX--o-XX
Xo---X-o
XX-#---X
X--#@XXX
X-----XX
XXXXXXXX
