XXXXXXXX
X----o-X
X-#-X--X
X-X#-XXX
XoX---XX
X-X@X--X
@--X--XX
XXXXXXXX
