XXXXXXXX
XX---X-X
X--##--X
Xo@----X
X----oXX
X---X--X
X--#XXXX
XXXXXXXX
