XXXXXXXX
X@-XXX-X
X---XXXX
X-##XX-X
X-@--o-X
Xo-XXXXX
X-XXX-XX
XXXXXXXX
