XXXXXXXX
XXX--X-X
Xo---XXX
X--@---X
X-##---X
X-----oX
X@X--X-X
XXXXXXXX
