XXXXXXXX
X--X-X-X
XX--Xo-X
XXX@X--X
X---X-XX
XX--#-XX
Xo-----X
XXXXXXXX
