XXXXXXXX
XX-X-XXX
X--XX-XX
XXXoX-@@
X----#-X
X---#--X
XXo-X-XX
XXXXXXXX
