XXXXXXXX
XXX--XXX
Xo-----X
X-X##--X
X-----XX
X-X@--Xo
XX-X-oXX
XXXXXXXX
