XXXXXXXX
XX----oX
X---#XXX
XXo---XX
XXX-@--X
XX---XXX
X-X-@-XX
XXXXXXXX
