XXXXXXX@
XX-Xo--X
X---X--X
XX---#-X
XX--@#-X
XX-X---X
XX----oX
XXXXXXXX
