XXXXXXXX
XX@-X@XX
X---XX-X
X-#----X
X--#X--X
X----o-X
Xo-X---X
XXXXXXXX
