XXXXXXXX
XXXX--XX
XX-oX-XX
XX---XXX
X-#----X
X-#---XX
XX--o-XX
XXXXXXXX
