XXXXXXXX
Xo-XX-XX
X-X---oX
X-#-#--X
@--X---X
XX--@-XX
XXXXX--X
XXXXXXXX
