XXXXXXXX
XXo----X
X--X-#@X
XX-#--XX
X------X
XXX@oX-X
XXX--X-X
XXXXXXXX
