XXXXXXXX
XXXXX-XX
Xo-XXX-X
X-----oX
X-##X--X
X---X--X
XX--@-XX
XXXXXXX@
