XXXXXXXX
XXX@--XX
X--#---X
XX--#-XX
X-o----#
X-XX--XX
XXXX-oXX
XXXXXXXX
