XXXXXXXX
X#XXoX-X
X-XX-XXX
XX-#-XXX
X-----XX
X-#---XX
X-@-oXXX
XXXXXXXX
