XXXXXXXX
X-X--XXX
XX-X@X-X
@oX----X
X--#--XX
X-#XX--X
X---oXXX
XXXXXXXX
