XXXXXX@X
X---X--X
Xo----XX
XX-#-XXX
X--#-XXX
XX---@-X
XXoX--XX
XXXXXXXX
