XXXXXXXX
XX-@XXXX
X-X-XXXX
X-#---XX
XX-##XXX
XX----oX
XXo-XXXX
XXXXXXXX
