XXXXXXXX
X@--o--X
X-#----X
#--X--XX
XX-#---X
Xo---X-X
XX-XXXXX
XXXXXXXX
