XXXXXXXX
XXo----X
X---#--X
XX--X-XX
X--oX--X
XX-XX-XX
XX--X-@X
XXXXXXXX
