XXXXXXXX
X-o----X
XX--##-X
XXX---@X
XX----XX
XX-o--#X
XXX-XXXX
XXXXXXXX
