XXXXXXXX
XXXXX-XX
XXXXXX-X
Xo@XXo-X
X--#---X
X-#-#--X
X----XXX
XXXXXXXX
