XXXXXXXX
XX-----X
X@--X-XX
X---o--X
X-#-X-XX
XX-#-X-X
XX@---XX
XXXXXXXX
