XXXXXXXX
XXoXXX-X
XX-X-XXX
X--#-@-X
XX-#X-XX
XX--XXXX
X---oX-X
XXXX#XXX
