XXXXXXXX
X@--X--X
XX#----X
X--#--XX
Xo---o-X
X-X---XX
XXo-X--X
XXXXXXXX
