XXXXX@XX
XX--XXXX
X-----XX
Xo-----X
XX-##-XX
X---@-XX
XXoX--XX
XXXXXXXX
