XXXXXXXX
XXXXX-XX
XoX--X-X
X-----XX
X-#--XXX
X--#---X
XoX-@-XX
XXXXXXoX
