XXXXXXXX
X-o-X@XX
XX-----X
XX-X--XX
XX-#XX-X
XX----oX
XX---X-X
XXXXXXXX
