XXXXXXXX
X-X----X
X-XX-oXX
Xo-----X
X--##--X
XX#----X
X-X@XX-X
XXXXXXXX
