XXXXXXXX
X@-XoXXX
X-----XX
X-##-X-X
X----XXX
X---oXXX
XX--X-XX
XXXX@XXX
