XXXXXXXX
Xo-----X
XX-##--X
X----XXX
XXo--XXX
X-XX@XXX
@--X--XX
XXXXXXXX
