X@XXXXXX
X--XX-XX
XXoX-X-X
XX--XXXX
XX-X-@XX
XX-#-#-X
Xo-----X
XXXXXXXX
