@XXXXXXX
X-X-XXXX
XXX-X--X
X---@-oX
XXX##--X
X------X
XXo---XX
XXXXXXXX
