XXXXXXXX
XXXXX@-X
XXX---XX
XXXX-@-X
XXX-#-XX
XXX---oX
X-Xo--XX
XXXXXXXX
