XXXXXXXX
Xo-----X
XX-#-o-X
X@-#--XX
XX-X--XX
XXXXo--X
XXXX-X-X
XXXXXXXX
