XXXXXXXX
Xo----XX
X----o-X
X-##---X
XX--XX-X
XX@-XXXX
X@--XX-X
XXXXXXXX
