XXXXXXXX
X--X-oXX
XX-#--XX
X-#---XX
X-X-oXXX
X-X--@XX
X@--XXXX
XXXXXXXX
