XXXXXXXX
X-@o-XXX
X-X-X-XX
X-#---XX
X-#--XXX
X---o--X
X--oXX-X
XXXXXXXX
