XXXXXXXX
XX-X-XXX
X@Xo-XXX
XXX-X-XX
X-X-#-@X
XXX-#-XX
XXo---XX
XXXXXXXX
