XXXXXXXX
XXX-XX-X
XoXX-XXX
X--#-XXX
X-#-@--X
X-#-XX-X
Xo--XXXX
XXXXXXXX
