XXXXXXXX
XXX---XX
X---#-XX
X---#--X
X-X@--XX
XX-o--XX
XXXX-o-X
#XXXXXXX
