XXXXXXXX
XX-Xo--X
XXXXX--X
X-oXX#-X
XX-X@#-X
XX--XX-X
XXX---oX
XXXXXXXX
