XXXXXXXX
XX-X@--X
XX--#o-X
X-o----X
XXXX--oX
X---X-XX
XXXX-X-X
XXXXXXXX
