XXXXXXXX
X-XX-XXX
XX-XX--X
XXXXXoXX
X---@-XX
X--##-XX
X-----oX
XXXXX@XX
