XXXXXXXX
XXXXX-XX
Xo-o-X-X
X--XX--X
X-#--XXX
X---#@-X
XoXXXXXX
XXXXXXXX
