XXXXXXXX
X-@-X-XX
X---XX-#
X--#---X
X-#-XXXX
X---oX-X
Xo--X--X
XXXXXXXX
