XXXXXXXX
X---o-XX
X-#-X-@X
X--#---X
XoX----o
X-----XX
XXX----X
XXXXXXXX
