XXXXXXXX
X---o--X
X-#-X--o
X-X#X--X
XoX--X-X
XXX--X-X
XX--@-XX
XXXXXXXX
