XXXXXXXX
X-X@-XoX
XXX----X
X-XX-#-X
XXXXX#-X
XXo----X
XX-XXXXX
XoXXXXXX
