XXXXXXXX
XX-X--XX
X--XXX-X
XXXo--XX
XXX--#-X
X#X-X#@X
XXo----X
XXXXXXXX
