XXXXXXXX
XXX-XXXX
X----XXX
X-#--XXX
X--#@X-X
X#-----X
XX-Xo-XX
XXXXXXXX
