XXXXXXXX
XX---XoX
X--@#--X
XXX-#-@X
X-o----X
XX-XXX-X
XX-XX-XX
XXXXXXXX
