XXXXXXXX
XX---XoX
X--@#--X
XXX-#--X
X-o----X
oX-XXX-X
XX-XX-XX
XXXXXXXX
