XXXXXXXX
X-o#--XX
X-X-#-XX
X------X
XX-#X-XX
XXX--oXX
XX-@-XXX
XXXXXXXX
