XXXXXXXX
XXX--X-X
XXo----X
XXX-##-X
XX#---@X
X-X-XXXX
XX-oXXXX
XXXXXXXX
