XXXXXXXX
X-XXXX-X
X-X---oX
X---#--X
XX-#@-XX
X---Xo-X
X-XXX-XX
XXoXXXXX
