XXXXXXXX
XXX-oX-X
X--#-X-X
XXXX-#-X
XXX--#-X
X--X---X
X-Xo--@X
XXXXXXXX
