XXXXXXXX
XXX----X
XXo----X
XXX-##-X
XXXX--oX
XX---@oX
XX----XX
XXXXXXXX
