XXXXXXXX
XXo----X
X-X-#-#X
X-X-X--X
XXX#X-XX
X---Xo-X
XXX@XXXX
XXXXXXXX
