XXXXXXXX
XX-----X
Xo--@-XX
XX-#-XXX
X--#---X
X--#-XXX
XXo---XX
XXXXXXXX
