XXXXXXXX
X---X--X
XXXXX--X
X--X-XXX
X--X-@XX
X--##--X
Xo--@-oX
XXXXXXXX
