#XXXXXXX
XXo----X
XXX-##-X
XX-X---X
XXXX@-oX
XXXX-X-X
XXXXXXXX
XXXXXXXX
