XXXXXXXX
X-XX-XXX
X-XXX-XX
X---oXXX
X-#--XXX
X--#-@XX
Xo----XX
XXXX#XXX
