XXXXXXXX
X-o----X
XXX-#--X
o-X--#@X
X--o--XX
X-XX--XX
XXXX---X
XXXXXXXX
