XXXXXXXX
X-o---oX
X---#--X
XX-#X--X
X-X--X-X
X-X@X--X
X-X-X--X
XXXXXXX@
