XXXXXXXX
XXX--X-X
XXX#@--X
X-o----X
X--X#X-X
XX-#--XX
XX---oXX
XXXXXXXX
