XXXXXX@X
XXXXX-XX
X---XXXX
XX-----X
XX----oX
X--##XXX
Xo---@XX
XXXXXXXX
