XXXXXXXX
XX-X--@X
X-X--#-X
X-XX---X
#XX---oX
X-X-#--X
XXo---XX
XXXXXXXX
