XXXXXXXX
XX-@---X
XX--#--X
X--X-#-X
X--o---X
XXXX-XoX
X----XXX
XXXX#XXX
