XXXXXXXX
XX-XXX-X
Xo---X-X
X---oX-X
X-#-XX-X
X--#X-XX
X---XX-X
XXXXXXXX
