XXXXXXXX
XX---XoX
XXXXXX-X
XXX-@#-X
XXX-X--X
XX-X-#-X
X--o---X
XX@XXXXX
