XXXXXXXX
XXXX@XXX
X----XXX
X--##-XX
Xo---#oX
XX-XXXXX
XXX-XXXX
XXXXXXXX
