XXXXX@XX
XXXXXXXX
X---o-XX
Xo--XX-X
X--#X-XX
XX#----X
XX@----X
XXXXXXXX
