XXXXXXXX
XXX-XXXo
X----oXX
X--#---X
XX-#-X-X
XX@--X-X
XX-Xo-XX
XXXXXXXX
