XXXXXXXX
XXoX-XXX
XX---o-X
XX-#---X
X---#--X
XXX@-XXX
XXX-@XXX
XXXXXXXX
