XXXXXXXX
@-Xo---X
X-XX-#@X
XXXX-#-X
XX-X-XXX
X--XoXXX
X----X-X
XXXXXXXX
