XXXXXXXX
XXXX-XXX
XXX-oXXX
X---@--X
XX-X-XXX
XX-#-XXX
Xo----XX
XXXXXXXX
