XXXXXXXX
X@-XXXo#
X---#--X
X-XXX#-X
X-XX---X
XXXX--oX
X-X--X-X
XXXXXXXX
