#XXXXXXX
X-XX---X
XXXXXX-X
XXXXoX-X
X-#--XXX
X@-#---X
X----oXX
XXXXXXXX
