XXXXXXXX
@XXX--oX
Xo-----X
X--#-#-X
XXX----X
XXX@X-XX
XX----XX
XXXXXXXX
