XXXXXXXX
XXXX-@XX
X---#X-X
@--#-XXX
XoX--o-X
X--XX-XX
X-XXX-XX
XXXXXXXX
