XXXXXXXX
XXo---XX
X-X---oX
XX--#X-X
X--#--XX
XX---X-X
X--X@--X
XXXXXXXo
