XXXXXXXX
X-o-XXXX
XX----oX
XX-##--X
XX-@---X
X-XXXXXX
X-X---#X
XXXXXXXX
