XXX@XXXX
X---XX-X
XXo-XXXX
X-----oX
XX-##XXX
XX-@---X
XXX-XX-X
XXXXXXXX
