XXXXXXXX
XXXX--oX
XoXX--XX
X--#--XX
X--X-#XX
X-@XX@XX
XXX-XXXX
XXXXXXXX
