XXXXXXXX
X--@-XXX
X--@--XX
X-#----X
X----o-X
XoXX--XX
XXXX-XXX
XXXXXXXX
