XXXXXXXX
X@--oXXX
X-#--XXX
X-#-X-XX
X----XX@
XXX---XX
XXXoXXXX
XXXXXXXX
