XXXXXXXX
X-----oX
XX--#-XX
X----#-X
XXXo#-@X
XXXX--XX
X---X--X
XXXXXXXX
