XXoXXXXX
XXXX-XoX
XXXo---X
XX---#-X
XXX-#X-X
XXX@---X
XXXX-X-X
XXXXXXXX
