XXXXXXXX
X-XX---X
X------X
X--XoX-X
X-#X--XX
X--#-X-X
Xo---X-X
XXXXXXXX
