XXXXXXXX
XXXXX--X
XX-----X
X-o---XX
o-X-#--X
XXX-#-XX
XXo@---X
XXXXXXXX
