XXXXXXXX
X----oXX
X--X-XXX
X--X--XX
X-#--XXX
Xo-#@--X
Xo-XXX-X
XXXXXXXX
