XXXXXXXX
X--X--XX
X-----oX
X-#-#-XX
X-X--oXX
Xo-X@XXX
X--X--XX
XXXXXXXX
