XXoXXXXX
Xo--XX-X
X---o-XX
X-#--XXX
X--#-XXX
XXX-XXXX
X-X@--XX
XXXXXXXX
