XXXXoXXX
XXX---oX
XX-X---X
XXX-X#XX
XX-XX--X
XXX-#--X
XXX@-XoX
XXXXXXXX
