XXXXXXXX
XXXX-X-X
XX-o-XXX
XXX--#-X
X-X-#X-X
X-----oX
X--X-XXX
XXXXXXXX
