XXXXXXXX
X--XX--X
X-#--XXX
X--@--XX
X-#-XXXX
X---oXXX
X-X--XXX
XXXXXXXX
