XXXXXXXX
Xo-XXX-X
X--o-o-X
X-##X--X
X--@XX-X
XXXXX--X
X---X-XX
XXXXXXXX
