XXXXXXXX
X---oXXX
X-#-X-XX
X-X#---X
XoXXXXXX
XXX--@XX
XXX----X
XXXXXXXX
