XXXXXXXX
X----oXX
X-o#-X-X
XX--#--X
XXoX---X
X-X--X@X
XXXX-X-X
XXXXXXXX
