oXXXXXXX
XX--o-XX
X-XX-XXX
X--#-XXX
X--#-XXX
X@---oXX
XXXX-XXX
XXXXXXXX
