XXXXXXXX
XX--o-XX
X-XX-oXX
X--#-XXX
X--#-XXX
X@---oXX
XXXX-XXX
XXXXXXXX
