XXXXXXXX
XXX--@-X
XX--##-X
X-o----X
XXXX-XoX
XXX-@X-X
X----XXX
XXXXXXXX
