XXXXXXXX
Xo--X-XX
X---@-XX
X-#X---X
X---o--X
X------X
X------X
XXXXXXXX
