XXXXXXXX
X-X@-XXX
X---#--X
X-X#---X
Xo---oXX
XX-X-XXX
X-X-XX-X
#XXXXXXX
