XXXXXXXX
X-X----X
X-XX---X
X-@---XX
X-X##--X
Xo----XX
XXo---XX
XX@XXXXX
