XXXXXXXX
X---XX@X
X-----oX
X--##--X
Xo----XX
X-XX@--X
XXX-X-XX
XXXXXXXX
