XXXXXXXX
Xo-X---X
X----XXX
X-#--o-X
X-#@---X
X-----XX
X--o---X
XXXXXXXX
