XXXXXXXX
X-XXXXXX
XXXXXXXX
#-o----X
XX--##-X
X-X--@-X
XXXo---X
XXXXXXXX
