XXXXXXXX
XX-Xo--X
XX-XX--X
X---X#-X
XX-o---X
X---X#-X
XoXXX-@X
XXXXXXXX
