XXXXXXXX
X@---X-X
X---o-XX
X-#X@XXX
X-#----X
X------X
X---XXXX
XXXXXXXX
