XXXXXXXX
XXo----X
X-X-#@-X
XXX-#--X
X-X--XXo
XXXoXXXX
X-X-XXXX
XXXXXXXX
