XXXXXXXX
XXX-XXoX
XXX@#--X
XXXX#--X
XXXX---X
X-Xo---X
XX-o--XX
XXXXXXXX
