XXXXXXXX
XXXX-XXX
XXoX-XXX
XX--#--X
X---#@-X
X-X---XX
X-@o--XX
XXXXXXXX
