XXXXXXXX
XXXXX-XX
X----oXX
XXo---XX
XX--#--X
X--#-X-X
XX--@XXo
XXXXXXXX
