XXXXXoXX
XX--o-XX
XXXX--XX
XX----XX
X--#-XXX
XX@#---X
XX---oXX
XXXXXXXX
