XXXXXXXX
X-XX--oo
X-X----X
XXX-X#-X
X-X--#-X
XX---X-X
X--@--oX
XXXXXXXX
