XXXXXXXX
X-----XX
X@---X-X
XX--#--X
X--#--XX
XX--XoXX
X----X-X
XXXXXXXX
