XXXXXXXX
X-X-XX-X
XX-o---X
XX---#-X
X---#-@X
XXo-X-XX
X#XX---X
XXXXXXXX
