XXXXXXXX
XXX-X-XX
XXX--X-X
X@@X-o-X
XX--X-XX
X--##-XX
Xo----XX
XXXXXXXX
