XXXXXXXX
XX--XX-X
XXX@---X
X-XX##-X
XXo----X
Xo-X---X
X---XXoX
XXXXXXXX
