XXXXXXXX
X--X-X-X
XX-XX--X
X---X-XX
XX--@XoX
X--##--X
XX-----X
XXXXXXXX
