XXXXXXXX
XXX-@-XX
XX---#XX
XX-o#-XX
XXX---oX
XXXo--XX
XX---XXX
XXXXXXXX
