XXXXXXXX
Xo--@X-X
X@-#--XX
X-#XXX-X
X---oXXX
X-X-XXXX
X-----XX
XXXXXXXX
