XXXXXXXX
XXXoXX-X
@X----oX
X-X----X
XXX-##XX
XX----XX
XXXXX@XX
XXXXXXXX
