XXXXXXXX
XX#----X
X-X-##-X
XX---@-X
X-XoX--X
XX-X---X
XX-XX-XX
XXXXXXXX
