XXXXXXXX
XXX@X-XX
XXX---oX
XXXX@--X
X----#-X
X-X-#--X
X-X-XXoX
XXXXXXXX
