XXXXXXXX
X---@-oX
XX-##-XX
XX----XX
XXoXXXXX
XXXX--Xo
X-XX--XX
XXXXXXXX
