XXXXXXXX
X@-----X
@X--##-X
X-o----X
X--X-XoX
XX-X-X-X
X--XXX-X
XXXXXXXX
