XXXXXXXX
XXX-XXXX
XXX-XoXX
XXX----X
X@--#--X
X-@X#--X
XXo---XX
XXXXXXXX
