XXX#XXXX
XX--@XXX
XX---X-X
XX-##--X
XX----oX
XXoXXXXX
XXX--X-X
XXXXXXXX
