XXXXXXXX
XXX-@-oX
XXX#-#-X
X------X
X-o----X
XX-X--oX
XXX--XXX
XXXXXXXX
