XXXXXXXX
XX---oXX
X-X--XXX
X-X-#-X@
X@-#--XX
X--XXo-X
X-XXXXXX
XXXXXXXX
