XXXXXXXX
X-X-X--X
XXX@XXoX
XXX#--XX
XXX-#XXX
XXo--XXX
XXX--o-X
XXXXXXXX
